rundate,this_period,foreign_region,foreign_country,UK_airport,foreign_airport,total_pax_this_period,total_pax_scheduled_this_period,total_pax_charter_this_period,total_pax_last_period,total_pax_scheduled_last_period,total_pax_charter_last_period,total_pax_percent
05-May-2016 09:32,201603,=,=,MANCHESTER,=, 457 , 0 , 457 , 0 , 0 , 0 , 0 
05-May-2016 09:32,201603,EASTERN EUROPE -OTHER,ALBANIA,GATWICK,TIRANA, 5711 , 5711 , 0 , 4436 , 4317 , 119 , 28.7421100090171 
05-May-2016 09:32,201603,NORTH AFRICA,ALGERIA,GATWICK,ALGIERS, 4011 , 4011 , 0 , 3298 , 3298 , 0 , 21.6191631291692 
05-May-2016 09:32,201603,NORTH AFRICA,ALGERIA,GATWICK,HASSI MESSAOUD, 0 , 0 , 0 , 756 , 0 , 756 , 0 
05-May-2016 09:32,201603,NORTH AFRICA,ALGERIA,HEATHROW,ALGIERS, 5642 , 5642 , 0 , 5420 , 5420 , 0 , 4.09594095940959 
05-May-2016 09:32,201603,NORTH AFRICA,ALGERIA,STANSTED,HASSI MESSAOUD, 714 , 0 , 714 , 0 , 0 , 0 , 0 
05-May-2016 09:32,201603,CENTRAL AFRICA,ANGOLA,HEATHROW,LUANDA, 1531 , 1531 , 0 , 2715 , 2715 , 0 ,-43.609576427256 
05-May-2016 09:32,201603,CARIBBEAN AREA,ANTIGUA AND BARBUDA,GATWICK,ANTIGUA, 10741 , 10741 , 0 , 12002 , 12002 , 0 ,-10.506582236294 
05-May-2016 09:32,201603,CARIBBEAN AREA,ANTIGUA AND BARBUDA,MANCHESTER,ANTIGUA, 926 , 926 , 0 , 0 , 0 , 0 , 0 
05-May-2016 09:32,201603,SOUTH AMERICA,ARGENTINA,HEATHROW,BUENOS AIRES, 13109 , 13109 , 0 , 15208 , 15208 , 0 ,-13.8019463440295 
05-May-2016 09:32,201603,AUSTRALASIA,AUSTRALIA,HEATHROW,MELBOURNE, 11471 , 11471 , 0 , 10939 , 10939 , 0 , 4.86333302861322 
05-May-2016 09:32,201603,AUSTRALASIA,AUSTRALIA,HEATHROW,SYDNEY, 24553 , 24553 , 0 , 25010 , 25010 , 0 ,-1.82726909236305 
05-May-2016 09:32,201603,WESTERN EUROPE-EU,AUSTRIA,BELFAST INTERNATIONAL,SALZBURG, 903 , 0 , 903 , 680 , 0 , 680 , 32.7941176470588 
05-May-2016 09:32,201603,WESTERN EUROPE-EU,AUSTRIA,BIRMINGHAM,INNSBRUCK, 3125 , 0 , 3125 , 3272 , 0 , 3272 ,-4.49266503667482 
05-May-2016 09:32,201603,WESTERN EUROPE-EU,AUSTRIA,BIRMINGHAM,SALZBURG, 2651 , 990 , 1661 , 1256 , 605 , 651 , 111.066878980892 
05-May-2016 09:32,201603,WESTERN EUROPE-EU,AUSTRIA,BRISTOL,INNSBRUCK, 4428 , 2134 , 2294 , 4661 , 2582 , 2079 ,-4.99892726882643 
05-May-2016 09:32,201603,WESTERN EUROPE-EU,AUSTRIA,BRISTOL,SALZBURG, 1837 , 1253 , 584 , 1508 , 1327 , 181 , 21.816976127321 
05-May-2016 09:32,201603,WESTERN EUROPE-EU,AUSTRIA,BRISTOL,VIENNA, 2162 , 2162 , 0 , 0 , 0 , 0 , 0 
05-May-2016 09:32,201603,WESTERN EUROPE-EU,AUSTRIA,EAST MIDLANDS INTERNATIONAL,SALZBURG, 496 , 0 , 496 , 181 , 0 , 181 , 174.033149171271 
05-May-2016 09:32,201603,WESTERN EUROPE-EU,AUSTRIA,EDINBURGH,INNSBRUCK, 2303 , 0 , 2303 , 2583 , 0 , 2583 ,-10.840108401084 
05-May-2016 09:32,201603,WESTERN EUROPE-EU,AUSTRIA,EDINBURGH,SALZBURG, 1323 , 1323 , 0 , 1107 , 1107 , 0 , 19.5121951219512 
05-May-2016 09:32,201603,WESTERN EUROPE-EU,AUSTRIA,EDINBURGH,VIENNA, 2600 , 2600 , 0 , 0 , 0 , 0 , 0 
05-May-2016 09:32,201603,WESTERN EUROPE-EU,AUSTRIA,GATWICK,INNSBRUCK, 39978 , 35368 , 4610 , 40287 , 25494 , 14793 ,-0.766996797974533 
05-May-2016 09:32,201603,WESTERN EUROPE-EU,AUSTRIA,GATWICK,SALZBURG, 20341 , 17455 , 2886 , 21583 , 16221 , 5362 ,-5.75452902747533 
05-May-2016 09:32,201603,WESTERN EUROPE-EU,AUSTRIA,GATWICK,VIENNA, 19896 , 19896 , 0 , 15217 , 15217 , 0 , 30.7485049615562 
05-May-2016 09:32,201603,WESTERN EUROPE-EU,AUSTRIA,GLASGOW,SALZBURG, 1001 , 809 , 192 , 212 , 0 , 212 , 372.169811320755 
05-May-2016 09:32,201603,WESTERN EUROPE-EU,AUSTRIA,HEATHROW,SALZBURG, 1776 , 1776 , 0 , 0 , 0 , 0 , 0 
05-May-2016 09:32,201603,WESTERN EUROPE-EU,AUSTRIA,HEATHROW,VIENNA, 56827 , 56827 , 0 , 55526 , 55526 , 0 , 2.34304650073839 
05-May-2016 09:32,201603,WESTERN EUROPE-EU,AUSTRIA,LEEDS BRADFORD,SALZBURG, 1092 , 1092 , 0 , 929 , 929 , 0 , 17.545748116254 
05-May-2016 09:32,201603,WESTERN EUROPE-EU,AUSTRIA,LIVERPOOL (JOHN LENNON),INNSBRUCK, 0 , 0 , 0 , 1440 , 1440 , 0 , 0 
05-May-2016 09:32,201603,WESTERN EUROPE-EU,AUSTRIA,LIVERPOOL (JOHN LENNON),SALZBURG, 1060 , 1060 , 0 , 1103 , 1103 , 0 ,-3.89845874886673 
05-May-2016 09:32,201603,WESTERN EUROPE-EU,AUSTRIA,LUTON,INNSBRUCK, 2296 , 2296 , 0 , 0 , 0 , 0 , 0 
05-May-2016 09:32,201603,WESTERN EUROPE-EU,AUSTRIA,LUTON,SALZBURG, 1813 , 1056 , 757 , 2073 , 1174 , 899 ,-12.5422093584178 
05-May-2016 09:32,201603,WESTERN EUROPE-EU,AUSTRIA,LUTON,VIENNA, 4549 , 4549 , 0 , 64 , 0 , 64 , 7007.8125 
05-May-2016 09:32,201603,WESTERN EUROPE-EU,AUSTRIA,MANCHESTER,INNSBRUCK, 9965 , 4121 , 5844 , 11301 , 3633 , 7668 ,-11.8219626581718 
05-May-2016 09:32,201603,WESTERN EUROPE-EU,AUSTRIA,MANCHESTER,SALZBURG, 4493 , 2532 , 1961 , 5208 , 1398 , 3810 ,-13.7288786482335 
05-May-2016 09:32,201603,WESTERN EUROPE-EU,AUSTRIA,MANCHESTER,VIENNA, 7692 , 7692 , 0 , 2386 , 2386 , 0 , 222.380553227158 
05-May-2016 09:32,201603,WESTERN EUROPE-EU,AUSTRIA,NEWCASTLE,INNSBRUCK, 1314 , 0 , 1314 , 1222 , 0 , 1222 , 7.52864157119476 
05-May-2016 09:32,201603,WESTERN EUROPE-EU,AUSTRIA,NEWCASTLE,SALZBURG, 897 , 0 , 897 , 855 , 0 , 855 , 4.91228070175439 
05-May-2016 09:32,201603,WESTERN EUROPE-EU,AUSTRIA,SOUTHAMPTON,INNSBRUCK, 393 , 0 , 393 , 740 , 0 , 740 ,-46.8918918918919 
05-May-2016 09:32,201603,WESTERN EUROPE-EU,AUSTRIA,SOUTHAMPTON,SALZBURG, 0 , 0 , 0 , 471 , 471 , 0 , 0 
05-May-2016 09:32,201603,WESTERN EUROPE-EU,AUSTRIA,STANSTED,INNSBRUCK, 2485 , 0 , 2485 , 2264 , 0 , 2264 , 9.76148409893993 
05-May-2016 09:32,201603,WESTERN EUROPE-EU,AUSTRIA,STANSTED,LINZ, 2684 , 2684 , 0 , 3707 , 3707 , 0 ,-27.5964391691395 
05-May-2016 09:32,201603,WESTERN EUROPE-EU,AUSTRIA,STANSTED,SALZBURG, 8748 , 8251 , 497 , 8741 , 8556 , 185 , 0.080082370438165 
05-May-2016 09:32,201603,WESTERN EUROPE-EU,AUSTRIA,STANSTED,VIENNA, 7474 , 7474 , 0 , 0 , 0 , 0 , 0 
05-May-2016 09:32,201603,EASTERN EUROPE -OTHER,AZERBAIJAN,HEATHROW,BAKU (HEYDER ALIYEV INT'L), 6489 , 6489 , 0 , 7064 , 7064 , 0 ,-8.13986409966025 
05-May-2016 09:32,201603,CARIBBEAN AREA,BAHAMAS,HEATHROW,NASSAU, 4615 , 4615 , 0 , 4456 , 4456 , 0 , 3.56822262118492 
05-May-2016 09:32,201603,MIDDLE EAST,BAHRAIN,HEATHROW,BAHRAIN, 25177 , 25177 , 0 , 22028 , 22028 , 0 , 14.2954421645179 
05-May-2016 09:32,201603,INDIAN SUB-CONTINENT,BANGLADESH,HEATHROW,DHAKHA, 6707 , 6707 , 0 , 6102 , 6102 , 0 , 9.91478203867584 
05-May-2016 09:32,201603,INDIAN SUB-CONTINENT,BANGLADESH,HEATHROW,SYLHET, 5902 , 5902 , 0 , 5125 , 5125 , 0 , 15.1609756097561 
05-May-2016 09:32,201603,CARIBBEAN AREA,BARBADOS,BIRMINGHAM,BRIDGETOWN, 5855 , 0 , 5855 , 6550 , 0 , 6550 ,-10.6106870229008 
05-May-2016 09:32,201603,CARIBBEAN AREA,BARBADOS,BOURNEMOUTH,BRIDGETOWN, 273 , 0 , 273 , 241 , 0 , 241 , 13.2780082987552 
05-May-2016 09:32,201603,CARIBBEAN AREA,BARBADOS,CARDIFF WALES,BRIDGETOWN, 291 , 0 , 291 , 256 , 0 , 256 , 13.671875 
05-May-2016 09:32,201603,CARIBBEAN AREA,BARBADOS,GATWICK,BRIDGETOWN, 46842 , 36566 , 10276 , 45743 , 35554 , 10189 , 2.40255339614804 
05-May-2016 09:32,201603,CARIBBEAN AREA,BARBADOS,GLASGOW,BRIDGETOWN, 290 , 0 , 290 , 260 , 0 , 260 , 11.5384615384615 
05-May-2016 09:32,201603,CARIBBEAN AREA,BARBADOS,HEATHROW,BRIDGETOWN, 454 , 454 , 0 , 0 , 0 , 0 , 0 
05-May-2016 09:32,201603,CARIBBEAN AREA,BARBADOS,MANCHESTER,BRIDGETOWN, 20940 , 9316 , 11624 , 20997 , 9654 , 11343 ,-0.271467352478926 
05-May-2016 09:32,201603,CARIBBEAN AREA,BARBADOS,NEWCASTLE,BRIDGETOWN, 588 , 0 , 588 , 0 , 0 , 0 , 0 
05-May-2016 09:32,201603,EASTERN EUROPE -OTHER,BELARUS,GATWICK,MINSK INT'L , 1477 , 1477 , 0 , 1508 , 1508 , 0 ,-2.05570291777188 
05-May-2016 09:32,201603,WESTERN EUROPE-EU,BELGIUM,BELFAST CITY (GEORGE BEST),ANTWERP, 64 , 64 , 0 , 0 , 0 , 0 , 0 
05-May-2016 09:32,201603,WESTERN EUROPE-EU,BELGIUM,BIRMINGHAM,ANTWERP, 260 , 260 , 0 , 0 , 0 , 0 , 0 
05-May-2016 09:32,201603,WESTERN EUROPE-EU,BELGIUM,BIRMINGHAM,BRUSSELS, 9473 , 9473 , 0 , 11837 , 11837 , 0 ,-19.9712765058714 
05-May-2016 09:32,201603,WESTERN EUROPE-EU,BELGIUM,BRISTOL,BRUSSELS, 3620 , 3620 , 0 , 4990 , 4990 , 0 ,-27.4549098196393 
05-May-2016 09:32,201603,WESTERN EUROPE-EU,BELGIUM,DURHAM TEES VALLEY,LIEGE, 0 , 0 , 0 , 20 , 0 , 20 , 0 
05-May-2016 09:32,201603,WESTERN EUROPE-EU,BELGIUM,EAST MIDLANDS INTERNATIONAL,BRUSSELS, 1286 , 1286 , 0 , 2592 , 2592 , 0 ,-50.3858024691358 
05-May-2016 09:32,201603,WESTERN EUROPE-EU,BELGIUM,EDINBURGH,ANTWERP, 484 , 484 , 0 , 0 , 0 , 0 , 0 
05-May-2016 09:32,201603,WESTERN EUROPE-EU,BELGIUM,EDINBURGH,BRUSSELS, 5220 , 5220 , 0 , 7908 , 7908 , 0 ,-33.9908952959029 
05-May-2016 09:32,201603,WESTERN EUROPE-EU,BELGIUM,EDINBURGH,CHARLEROI, 6442 , 6442 , 0 , 6007 , 6007 , 0 , 7.24155152322291 
05-May-2016 09:32,201603,WESTERN EUROPE-EU,BELGIUM,GATWICK,BRUSSELS, 3736 , 3736 , 0 , 11206 , 11206 , 0 ,-66.6607174727824 
05-May-2016 09:32,201603,WESTERN EUROPE-EU,BELGIUM,HEATHROW,BRUSSELS, 33560 , 33560 , 0 , 46853 , 46853 , 0 ,-28.371715791945 
05-May-2016 09:32,201603,WESTERN EUROPE-EU,BELGIUM,HEATHROW,LIEGE, 1203 , 1203 , 0 , 0 , 0 , 0 , 0 
05-May-2016 09:32,201603,WESTERN EUROPE-EU,BELGIUM,LONDON CITY,ANTWERP, 5382 , 5382 , 0 , 5298 , 5298 , 0 , 1.58550396375991 
05-May-2016 09:32,201603,WESTERN EUROPE-EU,BELGIUM,LUTON,BRUSSELS, 14 , 0 , 14 , 0 , 0 , 0 , 0 
05-May-2016 09:32,201603,WESTERN EUROPE-EU,BELGIUM,MANCHESTER,ANTWERP, 367 , 367 , 0 , 0 , 0 , 0 , 0 
05-May-2016 09:32,201603,WESTERN EUROPE-EU,BELGIUM,MANCHESTER,BRUSSELS, 13177 , 13177 , 0 , 18196 , 18196 , 0 ,-27.5829852714882 
05-May-2016 09:32,201603,WESTERN EUROPE-EU,BELGIUM,MANCHESTER,CHARLEROI, 14459 , 14459 , 0 , 14929 , 14929 , 0 ,-3.14823497890013 
05-May-2016 09:32,201603,WESTERN EUROPE-EU,BELGIUM,NEWCASTLE,BRUSSELS, 1479 , 1479 , 0 , 2272 , 2272 , 0 ,-34.9031690140845 
05-May-2016 09:32,201603,WESTERN EUROPE-EU,BELGIUM,NEWCASTLE,LIEGE, 6 , 0 , 6 , 0 , 0 , 0 , 0 
05-May-2016 09:32,201603,CARIBBEAN AREA,BERMUDA,GATWICK,BERMUDA, 6313 , 6313 , 0 , 6402 , 6402 , 0 ,-1.3901905654483 
05-May-2016 09:32,201603,CARIBBEAN AREA,BERMUDA,MANCHESTER,BERMUDA, 135 , 135 , 0 , 0 , 0 , 0 , 0 
05-May-2016 09:32,201603,SOUTH AMERICA,BRAZIL,HEATHROW,RIO DE JANEIRO (GALEAO), 11838 , 11838 , 0 , 13061 , 13061 , 0 ,-9.36375468953373 
05-May-2016 09:32,201603,SOUTH AMERICA,BRAZIL,HEATHROW,SAO PAULO (GUARULHOS), 35833 , 35833 , 0 , 35294 , 35294 , 0 , 1.52717175723919 
05-May-2016 09:32,201603,FAR EAST,BRUNEI,HEATHROW,BANDAR SERI BEGAWAN, 4898 , 4898 , 0 , 5518 , 5518 , 0 ,-11.2359550561798 
05-May-2016 09:32,201603,EASTERN EUROPE-EU,BULGARIA,BELFAST INTERNATIONAL,PLOVDIV, 1118 , 0 , 1118 , 684 , 0 , 684 , 63.4502923976608 
05-May-2016 09:32,201603,EASTERN EUROPE-EU,BULGARIA,BIRMINGHAM,SOFIA, 770 , 600 , 170 , 188 , 0 , 188 , 309.574468085106 
05-May-2016 09:32,201603,EASTERN EUROPE-EU,BULGARIA,BRISTOL,SOFIA, 3980 , 2784 , 1196 , 479 , 0 , 479 , 730.897703549061 
05-May-2016 09:32,201603,EASTERN EUROPE-EU,BULGARIA,EAST MIDLANDS INTERNATIONAL,SOFIA, 1000 , 0 , 1000 , 1170 , 0 , 1170 ,-14.5299145299145 
05-May-2016 09:32,201603,EASTERN EUROPE-EU,BULGARIA,GATWICK,PLOVDIV, 0 , 0 , 0 , 152 , 0 , 152 , 0 
05-May-2016 09:32,201603,EASTERN EUROPE-EU,BULGARIA,GATWICK,SOFIA, 13939 , 12734 , 1205 , 15183 , 13358 , 1825 ,-8.1933741684779 
05-May-2016 09:32,201603,EASTERN EUROPE-EU,BULGARIA,HEATHROW,SOFIA, 14779 , 14779 , 0 , 14653 , 14653 , 0 , 0.859892172251416 
05-May-2016 09:32,201603,EASTERN EUROPE-EU,BULGARIA,LUTON,BURGAS, 4429 , 4429 , 0 , 2902 , 2902 , 0 , 52.618883528601 
05-May-2016 09:32,201603,EASTERN EUROPE-EU,BULGARIA,LUTON,SOFIA, 21799 , 21799 , 0 , 15841 , 15841 , 0 , 37.6112619152831 
05-May-2016 09:32,201603,EASTERN EUROPE-EU,BULGARIA,LUTON,VARNA, 5410 , 5410 , 0 , 2904 , 2904 , 0 , 86.2947658402204 
05-May-2016 09:32,201603,EASTERN EUROPE-EU,BULGARIA,MANCHESTER,SOFIA, 6403 , 4847 , 1556 , 4946 , 4357 , 589 , 29.4581479983825 
05-May-2016 09:32,201603,EASTERN EUROPE-EU,BULGARIA,NEWCASTLE,SOFIA, 397 , 0 , 397 , 0 , 0 , 0 , 0 
05-May-2016 09:32,201603,EASTERN EUROPE-EU,BULGARIA,STANSTED,PLOVDIV, 3652 , 3652 , 0 , 3289 , 3289 , 0 , 11.0367892976589 
05-May-2016 09:32,201603,EASTERN EUROPE-EU,BULGARIA,STANSTED,SOFIA, 2533 , 2533 , 0 , 2787 , 2787 , 0 ,-9.11374237531396 
05-May-2016 09:32,201603,CANADA,CANADA,GATWICK,CALGARY, 0 , 0 , 0 , 1923 , 1923 , 0 , 0 
05-May-2016 09:32,201603,CANADA,CANADA,GATWICK,TORONTO, 11025 , 11025 , 0 , 6876 , 6876 , 0 , 60.3403141361256 
05-May-2016 09:32,201603,CANADA,CANADA,GATWICK,VANCOUVER, 5820 , 5820 , 0 , 4286 , 4286 , 0 , 35.790947270182 
05-May-2016 09:32,201603,CANADA,CANADA,GLASGOW,TORONTO, 2300 , 2300 , 0 , 1752 , 1752 , 0 , 31.2785388127854 
05-May-2016 09:32,201603,CANADA,CANADA,HEATHROW,CALGARY, 25989 , 25989 , 0 , 25381 , 25381 , 0 , 2.39549269138332 
05-May-2016 09:32,201603,CANADA,CANADA,HEATHROW,EDMONTON, 0 , 0 , 0 , 971 , 971 , 0 , 0 
05-May-2016 09:32,201603,CANADA,CANADA,HEATHROW,HALIFAX INT, 5227 , 5227 , 0 , 4931 , 4931 , 0 , 6.00283918069357 
05-May-2016 09:32,201603,CANADA,CANADA,HEATHROW,MONTREAL (DORVAL), 23096 , 23096 , 0 , 23546 , 23546 , 0 ,-1.91115263739064 
05-May-2016 09:32,201603,CANADA,CANADA,HEATHROW,OTTAWA INTERNATIONAL, 9803 , 9803 , 0 , 9356 , 9356 , 0 , 4.77768277041471 
05-May-2016 09:32,201603,CANADA,CANADA,HEATHROW,ST JOHNS, 2070 , 2070 , 0 , 2235 , 2235 , 0 ,-7.38255033557047 
05-May-2016 09:32,201603,CANADA,CANADA,HEATHROW,TORONTO, 82726 , 82726 , 0 , 77246 , 77246 , 0 , 7.09421847085933 
05-May-2016 09:32,201603,CANADA,CANADA,HEATHROW,VANCOUVER, 44610 , 44610 , 0 , 44104 , 44104 , 0 , 1.14728822782514 
05-May-2016 09:32,201603,CANADA,CANADA,MANCHESTER,TORONTO, 2389 , 2389 , 0 , 2272 , 2272 , 0 , 5.14964788732394 
05-May-2016 09:32,201603,ATLANTIC OCEAN ISLANDS,CAPE VERDE ISLANDS,BIRMINGHAM,BOA VISTA (RABIL), 2068 , 2068 , 0 , 1591 , 1591 , 0 , 29.9811439346323 
05-May-2016 09:32,201603,ATLANTIC OCEAN ISLANDS,CAPE VERDE ISLANDS,BIRMINGHAM,ILHA DO SAL C.VERDE, 1916 , 1916 , 0 , 1849 , 1849 , 0 , 3.62358031368307 
05-May-2016 09:32,201603,ATLANTIC OCEAN ISLANDS,CAPE VERDE ISLANDS,BRISTOL,ILHA DO SAL C.VERDE, 1658 , 1658 , 0 , 0 , 0 , 0 , 0 
05-May-2016 09:32,201603,ATLANTIC OCEAN ISLANDS,CAPE VERDE ISLANDS,GATWICK,BOA VISTA (RABIL), 5358 , 5358 , 0 , 3864 , 3864 , 0 , 38.6645962732919 
05-May-2016 09:32,201603,ATLANTIC OCEAN ISLANDS,CAPE VERDE ISLANDS,GATWICK,ILHA DO SAL C.VERDE, 7863 , 7863 , 0 , 6453 , 6109 , 344 , 21.8503021850302 
05-May-2016 09:32,201603,ATLANTIC OCEAN ISLANDS,CAPE VERDE ISLANDS,MANCHESTER,BOA VISTA (RABIL), 3776 , 3776 , 0 , 3715 , 3715 , 0 , 1.64199192462988 
05-May-2016 09:32,201603,ATLANTIC OCEAN ISLANDS,CAPE VERDE ISLANDS,MANCHESTER,ILHA DO SAL C.VERDE, 6915 , 6915 , 0 , 3160 , 3160 , 0 , 118.829113924051 
05-May-2016 09:32,201603,ATLANTIC OCEAN ISLANDS,CAPE VERDE ISLANDS,STANSTED,BOA VISTA (RABIL), 201 , 201 , 0 , 0 , 0 , 0 , 0 
05-May-2016 09:32,201603,CARIBBEAN AREA,CAYMAN ISLANDS,HEATHROW,GRAND CAYMAN, 2822 , 2822 , 0 , 2495 , 2495 , 0 , 13.1062124248497 
05-May-2016 09:32,201603,FAR EAST,CHINA,HEATHROW,BEIJING, 35540 , 35540 , 0 , 29224 , 29224 , 0 , 21.6123733917328 
05-May-2016 09:32,201603,FAR EAST,CHINA,HEATHROW,CHENGDU, 2633 , 2633 , 0 , 3094 , 3094 , 0 ,-14.8998060762767 
05-May-2016 09:32,201603,FAR EAST,CHINA,HEATHROW,GUANGZHOU BAIYUN INTERNATIONAL, 11070 , 11070 , 0 , 10848 , 10848 , 0 , 2.04646017699115 
05-May-2016 09:32,201603,FAR EAST,CHINA,HEATHROW,SHANGHAI (PU DONG), 34388 , 34388 , 0 , 31680 , 31680 , 0 , 8.5479797979798 
05-May-2016 09:32,201603,SOUTH AMERICA,COLOMBIA,GATWICK,CARTAGENA, 501 , 0 , 501 , 0 , 0 , 0 , 0 
05-May-2016 09:32,201603,SOUTH AMERICA,COLOMBIA,HEATHROW,BOGOTA, 11859 , 11859 , 0 , 6647 , 6647 , 0 , 78.4113133744546 
05-May-2016 09:32,201603,CENTRAL AMERICA,COSTA RICA,GATWICK,LIBERIA, 2448 , 0 , 2448 , 0 , 0 , 0 , 0 
05-May-2016 09:32,201603,WESTERN EUROPE-EU,CROATIA,GATWICK,DUBROVNIK, 2069 , 2069 , 0 , 2435 , 2435 , 0 ,-15.0308008213552 
05-May-2016 09:32,201603,WESTERN EUROPE-EU,CROATIA,GATWICK,PULA, 235 , 235 , 0 , 0 , 0 , 0 , 0 
05-May-2016 09:32,201603,WESTERN EUROPE-EU,CROATIA,GATWICK,SPLIT, 274 , 274 , 0 , 0 , 0 , 0 , 0 
05-May-2016 09:32,201603,WESTERN EUROPE-EU,CROATIA,HEATHROW,ZAGREB, 14365 , 14365 , 0 , 14734 , 14734 , 0 ,-2.50441156508755 
05-May-2016 09:32,201603,WESTERN EUROPE-EU,CROATIA,MANCHESTER,ZADAR, 0 , 0 , 0 , 176 , 176 , 0 , 0 
05-May-2016 09:32,201603,WESTERN EUROPE-EU,CROATIA,STANSTED,OSIJEK, 0 , 0 , 0 , 325 , 325 , 0 , 0 
05-May-2016 09:32,201603,WESTERN EUROPE-EU,CROATIA,STANSTED,PULA, 0 , 0 , 0 , 254 , 254 , 0 , 0 
05-May-2016 09:32,201603,WESTERN EUROPE-EU,CROATIA,STANSTED,ZADAR, 0 , 0 , 0 , 297 , 297 , 0 , 0 
05-May-2016 09:32,201603,CENTRAL AMERICA,CUBA,GATWICK,HAVANA, 9601 , 9601 , 0 , 7822 , 7822 , 0 , 22.7435438506776 
05-May-2016 09:32,201603,CENTRAL AMERICA,CUBA,GATWICK,HOLGUIN (FRANK PAIS), 3118 , 3118 , 0 , 2872 , 0 , 2872 , 8.56545961002785 
05-May-2016 09:32,201603,CENTRAL AMERICA,CUBA,MANCHESTER,CUNAGUA (CAYO COCO), 3128 , 3128 , 0 , 2550 , 0 , 2550 , 22.6666666666667 
05-May-2016 09:32,201603,CENTRAL AMERICA,CUBA,MANCHESTER,HOLGUIN (FRANK PAIS), 2786 , 0 , 2786 , 3176 , 0 , 3176 ,-12.27959697733 
05-May-2016 09:32,201603,CENTRAL AMERICA,CUBA,MANCHESTER,VARADERO, 2466 , 2466 , 0 , 2548 , 0 , 2548 ,-3.2182103610675 
05-May-2016 09:32,201603,WESTERN EUROPE-EU,CYPRUS,BELFAST INTERNATIONAL,LARNACA, 670 , 0 , 670 , 0 , 0 , 0 , 0 
05-May-2016 09:32,201603,WESTERN EUROPE-EU,CYPRUS,BIRMINGHAM,LARNACA, 4522 , 3512 , 1010 , 3248 , 3029 , 219 , 39.2241379310345 
05-May-2016 09:32,201603,WESTERN EUROPE-EU,CYPRUS,BIRMINGHAM,PAPHOS, 3143 , 139 , 3004 , 2497 , 0 , 2497 , 25.8710452543052 
05-May-2016 09:32,201603,WESTERN EUROPE-EU,CYPRUS,BOURNEMOUTH,PAPHOS, 1583 , 0 , 1583 , 1213 , 0 , 1213 , 30.5028854080791 
05-May-2016 09:32,201603,WESTERN EUROPE-EU,CYPRUS,BRISTOL,LARNACA, 227 , 0 , 227 , 0 , 0 , 0 , 0 
05-May-2016 09:32,201603,WESTERN EUROPE-EU,CYPRUS,BRISTOL,PAPHOS, 5195 , 3286 , 1909 , 3031 , 3031 , 0 , 71.3955790168261 
05-May-2016 09:32,201603,WESTERN EUROPE-EU,CYPRUS,CARDIFF WALES,PAPHOS, 1649 , 0 , 1649 , 1140 , 0 , 1140 , 44.6491228070175 
05-May-2016 09:32,201603,WESTERN EUROPE-EU,CYPRUS,DONCASTER SHEFFIELD,PAPHOS, 1711 , 0 , 1711 , 1251 , 0 , 1251 , 36.7705835331735 
05-May-2016 09:32,201603,WESTERN EUROPE-EU,CYPRUS,EAST MIDLANDS INTERNATIONAL,LARNACA, 0 , 0 , 0 , 251 , 0 , 251 , 0 
05-May-2016 09:32,201603,WESTERN EUROPE-EU,CYPRUS,EAST MIDLANDS INTERNATIONAL,PAPHOS, 3007 , 534 , 2473 , 2361 , 204 , 2157 , 27.3612875900042 
05-May-2016 09:32,201603,WESTERN EUROPE-EU,CYPRUS,EDINBURGH,PAPHOS, 3280 , 3095 , 185 , 2756 , 2756 , 0 , 19.0130624092888 
05-May-2016 09:32,201603,WESTERN EUROPE-EU,CYPRUS,EXETER,PAPHOS, 1624 , 0 , 1624 , 1211 , 0 , 1211 , 34.1040462427746 
05-May-2016 09:32,201603,WESTERN EUROPE-EU,CYPRUS,GATWICK,LARNACA, 15486 , 15179 , 307 , 14896 , 14707 , 189 , 3.96079484425349 
05-May-2016 09:32,201603,WESTERN EUROPE-EU,CYPRUS,GATWICK,PAPHOS, 20642 , 12030 , 8612 , 18050 , 11461 , 6589 , 14.3601108033241 
05-May-2016 09:32,201603,WESTERN EUROPE-EU,CYPRUS,GLASGOW,LARNACA, 217 , 0 , 217 , 0 , 0 , 0 , 0 
05-May-2016 09:32,201603,WESTERN EUROPE-EU,CYPRUS,GLASGOW,PAPHOS, 2666 , 520 , 2146 , 1494 , 0 , 1494 , 78.4471218206158 
05-May-2016 09:32,201603,WESTERN EUROPE-EU,CYPRUS,HEATHROW,LARNACA, 20840 , 20840 , 0 , 14701 , 14701 , 0 , 41.7590640092511 
05-May-2016 09:32,201603,WESTERN EUROPE-EU,CYPRUS,LEEDS BRADFORD,PAPHOS, 551 , 551 , 0 , 0 , 0 , 0 , 0 
05-May-2016 09:32,201603,WESTERN EUROPE-EU,CYPRUS,LIVERPOOL (JOHN LENNON),LARNACA, 2926 , 2926 , 0 , 3032 , 3032 , 0 ,-3.49604221635884 
05-May-2016 09:32,201603,WESTERN EUROPE-EU,CYPRUS,LUTON,LARNACA, 2220 , 2220 , 0 , 625 , 625 , 0 , 255.2 
05-May-2016 09:32,201603,WESTERN EUROPE-EU,CYPRUS,LUTON,PAPHOS, 4833 , 4646 , 187 , 4422 , 4422 , 0 , 9.2944369063772 
05-May-2016 09:32,201603,WESTERN EUROPE-EU,CYPRUS,MANCHESTER,LARNACA, 1201 , 0 , 1201 , 1629 , 1227 , 402 ,-26.2737875997544 
05-May-2016 09:32,201603,WESTERN EUROPE-EU,CYPRUS,MANCHESTER,PAPHOS, 17281 , 8648 , 8633 , 15001 , 7902 , 7099 , 15.1989867342177 
05-May-2016 09:32,201603,WESTERN EUROPE-EU,CYPRUS,NEWCASTLE,LARNACA, 184 , 0 , 184 , 0 , 0 , 0 , 0 
05-May-2016 09:32,201603,WESTERN EUROPE-EU,CYPRUS,NEWCASTLE,PAPHOS, 3134 , 584 , 2550 , 1452 , 0 , 1452 , 115.840220385675 
05-May-2016 09:32,201603,WESTERN EUROPE-EU,CYPRUS,STANSTED,PAPHOS, 10946 , 10567 , 379 , 10711 , 10524 , 187 , 2.19400616188965 
05-May-2016 09:32,201603,EASTERN EUROPE-EU,CZECH REPUBLIC,BIRMINGHAM,BRNO (TURANY), 0 , 0 , 0 , 43 , 0 , 43 , 0 
05-May-2016 09:32,201603,EASTERN EUROPE-EU,CZECH REPUBLIC,BRISTOL,PRAGUE, 4966 , 4966 , 0 , 5292 , 5292 , 0 ,-6.16024187452759 
05-May-2016 09:32,201603,EASTERN EUROPE-EU,CZECH REPUBLIC,EAST MIDLANDS INTERNATIONAL,PRAGUE, 2181 , 2181 , 0 , 2719 , 2719 , 0 ,-19.7866862817212 
05-May-2016 09:32,201603,EASTERN EUROPE-EU,CZECH REPUBLIC,EDINBURGH,PRAGUE, 5909 , 5909 , 0 , 5263 , 5263 , 0 , 12.2743682310469 
05-May-2016 09:32,201603,EASTERN EUROPE-EU,CZECH REPUBLIC,GATWICK,PRAGUE, 22956 , 22956 , 0 , 18742 , 18742 , 0 , 22.4842599509124 
05-May-2016 09:32,201603,EASTERN EUROPE-EU,CZECH REPUBLIC,GLASGOW,PRAGUE, 1074 , 900 , 174 , 0 , 0 , 0 , 0 
05-May-2016 09:32,201603,EASTERN EUROPE-EU,CZECH REPUBLIC,HEATHROW,PRAGUE, 34925 , 34925 , 0 , 33263 , 33263 , 0 , 4.99654270510778 
05-May-2016 09:32,201603,EASTERN EUROPE-EU,CZECH REPUBLIC,LEEDS BRADFORD,PRAGUE, 2715 , 2715 , 0 , 2417 , 2417 , 0 , 12.3293338849814 
05-May-2016 09:32,201603,EASTERN EUROPE-EU,CZECH REPUBLIC,LIVERPOOL (JOHN LENNON),PRAGUE, 213 , 213 , 0 , 0 , 0 , 0 , 0 
05-May-2016 09:32,201603,EASTERN EUROPE-EU,CZECH REPUBLIC,LUTON,BRNO (TURANY), 3669 , 3669 , 0 , 3612 , 3612 , 0 , 1.578073089701 
05-May-2016 09:32,201603,EASTERN EUROPE-EU,CZECH REPUBLIC,LUTON,PRAGUE, 10249 , 10249 , 0 , 10402 , 10402 , 0 ,-1.47087098634878 
05-May-2016 09:32,201603,EASTERN EUROPE-EU,CZECH REPUBLIC,MANCHESTER,PRAGUE, 11504 , 11504 , 0 , 10273 , 10273 , 0 , 11.9828677114767 
05-May-2016 09:32,201603,EASTERN EUROPE-EU,CZECH REPUBLIC,NEWCASTLE,PRAGUE, 2239 , 2239 , 0 , 2414 , 2414 , 0 ,-7.24937862468931 
05-May-2016 09:32,201603,EASTERN EUROPE-EU,CZECH REPUBLIC,STANSTED,BRNO (TURANY), 8425 , 8425 , 0 , 9890 , 9890 , 0 ,-14.8129423660263 
05-May-2016 09:32,201603,EASTERN EUROPE-EU,CZECH REPUBLIC,STANSTED,OSTRAVA, 5888 , 5888 , 0 , 4319 , 4319 , 0 , 36.327853669831 
05-May-2016 09:32,201603,EASTERN EUROPE-EU,CZECH REPUBLIC,STANSTED,PRAGUE, 32651 , 32651 , 0 , 23419 , 23419 , 0 , 39.4209829625518 
05-May-2016 09:32,201603,WESTERN EUROPE-EU,DENMARK,ABERDEEN,COPENHAGEN, 2649 , 2649 , 0 , 3014 , 3014 , 0 ,-12.1101526211015 
05-May-2016 09:32,201603,WESTERN EUROPE-EU,DENMARK,ABERDEEN,ESBJERG, 558 , 558 , 0 , 921 , 921 , 0 ,-39.413680781759 
05-May-2016 09:32,201603,WESTERN EUROPE-EU,DENMARK,BIRMINGHAM,COPENHAGEN, 6627 , 6627 , 0 , 7378 , 7378 , 0 ,-10.1789102737869 
05-May-2016 09:32,201603,WESTERN EUROPE-EU,DENMARK,BRISTOL,COPENHAGEN, 2298 , 2298 , 0 , 3657 , 3657 , 0 ,-37.1616078753076 
05-May-2016 09:32,201603,WESTERN EUROPE-EU,DENMARK,EDINBURGH,COPENHAGEN, 17634 , 17634 , 0 , 8979 , 8979 , 0 , 96.3915803541597 
05-May-2016 09:32,201603,WESTERN EUROPE-EU,DENMARK,GATWICK,AALBORG, 2631 , 2631 , 0 , 2935 , 2935 , 0 ,-10.3577512776831 
05-May-2016 09:32,201603,WESTERN EUROPE-EU,DENMARK,GATWICK,COPENHAGEN, 63143 , 63143 , 0 , 69627 , 69627 , 0 ,-9.31247935427348 
05-May-2016 09:32,201603,WESTERN EUROPE-EU,DENMARK,GLASGOW,COPENHAGEN, 32 , 0 , 32 , 0 , 0 , 0 , 0 
05-May-2016 09:32,201603,WESTERN EUROPE-EU,DENMARK,GLASGOW,KARUP, 37 , 0 , 37 , 0 , 0 , 0 , 0 
05-May-2016 09:32,201603,WESTERN EUROPE-EU,DENMARK,HEATHROW,COPENHAGEN, 79352 , 79352 , 0 , 83006 , 83006 , 0 ,-4.40209141507843 
05-May-2016 09:32,201603,WESTERN EUROPE-EU,DENMARK,LONDON CITY,BILLUND, 2064 , 2064 , 0 , 2084 , 2084 , 0 ,-0.959692898272553 
05-May-2016 09:32,201603,WESTERN EUROPE-EU,DENMARK,LUTON,COPENHAGEN, 66164 , 66164 , 0 , 17535 , 17535 , 0 , 277.325349301397 
05-May-2016 09:32,201603,WESTERN EUROPE-EU,DENMARK,MANCHESTER,AARHUS (TIRSTRUP), 0 , 0 , 0 , 913 , 913 , 0 , 0 
05-May-2016 09:32,201603,WESTERN EUROPE-EU,DENMARK,MANCHESTER,BILLUND, 1967 , 1967 , 0 , 2434 , 2434 , 0 ,-19.1865242399343 
05-May-2016 09:32,201603,WESTERN EUROPE-EU,DENMARK,MANCHESTER,COPENHAGEN, 25273 , 25273 , 0 , 25368 , 25368 , 0 ,-0.374487543361716 
05-May-2016 09:32,201603,WESTERN EUROPE-EU,DENMARK,NEWCASTLE,COPENHAGEN, 1272 , 1272 , 0 , 1670 , 1670 , 0 ,-23.8323353293413 
05-May-2016 09:32,201603,WESTERN EUROPE-EU,DENMARK,SOUTHEND,BILLUND, 36 , 36 , 0 , 0 , 0 , 0 , 0 
05-May-2016 09:32,201603,WESTERN EUROPE-EU,DENMARK,STANSTED,AARHUS (TIRSTRUP), 7853 , 7853 , 0 , 6053 , 6053 , 0 , 29.737320337023 
05-May-2016 09:32,201603,WESTERN EUROPE-EU,DENMARK,STANSTED,BILLUND, 17442 , 17442 , 0 , 22699 , 22699 , 0 ,-23.1596105555311 
05-May-2016 09:32,201603,WESTERN EUROPE-EU,DENMARK,STANSTED,COPENHAGEN, 0 , 0 , 0 , 2167 , 2167 , 0 , 0 
05-May-2016 09:32,201603,CENTRAL AMERICA,DOMINICAN REPUBLIC,GATWICK,PUERTO PLATA, 2955 , 0 , 2955 , 2287 , 0 , 2287 , 29.2085701792742 
05-May-2016 09:32,201603,CENTRAL AMERICA,DOMINICAN REPUBLIC,GATWICK,PUNTA CANA, 9439 , 4207 , 5232 , 11385 , 4209 , 7176 ,-17.092665788318 
05-May-2016 09:32,201603,CENTRAL AMERICA,DOMINICAN REPUBLIC,MANCHESTER,PUERTO PLATA, 2380 , 0 , 2380 , 2718 , 0 , 2718 ,-12.4356144223694 
05-May-2016 09:32,201603,CENTRAL AMERICA,DOMINICAN REPUBLIC,MANCHESTER,PUNTA CANA, 7542 , 0 , 7542 , 4297 , 0 , 4297 , 75.5178031184547 
05-May-2016 09:32,201603,SOUTH AMERICA,ECUADOR,GATWICK,GUAYAQUIL, 868 , 0 , 868 , 0 , 0 , 0 , 0 
05-May-2016 09:32,201603,NORTH AFRICA,EGYPT,BIRMINGHAM,HURGHADA, 1565 , 0 , 1565 , 4095 , 2710 , 1385 ,-61.7826617826618 
05-May-2016 09:32,201603,NORTH AFRICA,EGYPT,BIRMINGHAM,SHARM EL SHEIKH (OPHIRA), 0 , 0 , 0 , 11286 , 5297 , 5989 , 0 
05-May-2016 09:32,201603,NORTH AFRICA,EGYPT,BRISTOL,SHARM EL SHEIKH (OPHIRA), 0 , 0 , 0 , 3831 , 0 , 3831 , 0 
05-May-2016 09:32,201603,NORTH AFRICA,EGYPT,CARDIFF WALES,SHARM EL SHEIKH (OPHIRA), 0 , 0 , 0 , 1428 , 0 , 1428 , 0 
05-May-2016 09:32,201603,NORTH AFRICA,EGYPT,DONCASTER SHEFFIELD,SHARM EL SHEIKH (OPHIRA), 0 , 0 , 0 , 3201 , 0 , 3201 , 0 
05-May-2016 09:32,201603,NORTH AFRICA,EGYPT,EAST MIDLANDS INTERNATIONAL,HURGHADA, 2066 , 0 , 2066 , 2091 , 0 , 2091 ,-1.19560019129603 
05-May-2016 09:32,201603,NORTH AFRICA,EGYPT,EAST MIDLANDS INTERNATIONAL,SHARM EL SHEIKH (OPHIRA), 0 , 0 , 0 , 4948 , 0 , 4948 , 0 
05-May-2016 09:32,201603,NORTH AFRICA,EGYPT,EDINBURGH,SHARM EL SHEIKH (OPHIRA), 0 , 0 , 0 , 2139 , 0 , 2139 , 0 
05-May-2016 09:32,201603,NORTH AFRICA,EGYPT,EXETER,SHARM EL SHEIKH (OPHIRA), 0 , 0 , 0 , 1421 , 0 , 1421 , 0 
05-May-2016 09:32,201603,NORTH AFRICA,EGYPT,GATWICK,HURGHADA, 13998 , 7476 , 6522 , 19147 , 8783 , 10364 ,-26.8919412962866 
05-May-2016 09:32,201603,NORTH AFRICA,EGYPT,GATWICK,LUXOR, 1304 , 0 , 1304 , 1291 , 0 , 1291 , 1.00697134004648 
05-May-2016 09:32,201603,NORTH AFRICA,EGYPT,GATWICK,MARSA ALAM, 1625 , 0 , 1625 , 1303 , 0 , 1303 , 24.712202609363 
05-May-2016 09:32,201603,NORTH AFRICA,EGYPT,GATWICK,SHARM EL SHEIKH (OPHIRA), 0 , 0 , 0 , 40913 , 23196 , 17717 , 0 
05-May-2016 09:32,201603,NORTH AFRICA,EGYPT,GLASGOW,SHARM EL SHEIKH (OPHIRA), 0 , 0 , 0 , 3787 , 0 , 3787 , 0 
05-May-2016 09:32,201603,NORTH AFRICA,EGYPT,HEATHROW,CAIRO, 27331 , 27331 , 0 , 25841 , 25841 , 0 , 5.76603072636508 
05-May-2016 09:32,201603,NORTH AFRICA,EGYPT,HEATHROW,LUXOR, 684 , 684 , 0 , 1339 , 1339 , 0 ,-48.9171023151606 
05-May-2016 09:32,201603,NORTH AFRICA,EGYPT,LUTON,SHARM EL SHEIKH (OPHIRA), 0 , 0 , 0 , 13751 , 12162 , 1589 , 0 
05-May-2016 09:32,201603,NORTH AFRICA,EGYPT,MANCHESTER,HURGHADA, 10995 , 2663 , 8332 , 10246 , 2705 , 7541 , 7.3101698223697 
05-May-2016 09:32,201603,NORTH AFRICA,EGYPT,MANCHESTER,SHARM EL SHEIKH (OPHIRA), 0 , 0 , 0 , 28325 , 11378 , 16947 , 0 
05-May-2016 09:32,201603,NORTH AFRICA,EGYPT,NEWCASTLE,HURGHADA, 0 , 0 , 0 , 2013 , 0 , 2013 , 0 
05-May-2016 09:32,201603,NORTH AFRICA,EGYPT,NEWCASTLE,SHARM EL SHEIKH (OPHIRA), 0 , 0 , 0 , 4884 , 0 , 4884 , 0 
05-May-2016 09:32,201603,NORTH AFRICA,EGYPT,STANSTED,SHARM EL SHEIKH (OPHIRA), 0 , 0 , 0 , 6646 , 4846 , 1800 , 0 
05-May-2016 09:32,201603,EASTERN EUROPE-EU,ESTONIA,GATWICK,TALLIN, 2297 , 2297 , 0 , 5346 , 5346 , 0 ,-57.0332959221848 
05-May-2016 09:32,201603,EASTERN EUROPE-EU,ESTONIA,STANSTED,TALLIN, 6085 , 6085 , 0 , 5949 , 5949 , 0 , 2.28609850395024 
05-May-2016 09:32,201603,EAST AFRICA,ETHIOPIA,HEATHROW,ADDIS ABABA, 14203 , 14203 , 0 , 11013 , 11013 , 0 , 28.9657677290475 
05-May-2016 09:32,201603,WESTERN EUROPE-OTHER,FAROE ISLANDS,EDINBURGH,VAGAR, 711 , 711 , 0 , 102 , 102 , 0 , 597.058823529412 
05-May-2016 09:32,201603,WESTERN EUROPE-OTHER,FAROE ISLANDS,GATWICK,VAGAR, 0 , 0 , 0 , 243 , 0 , 243 , 0 
05-May-2016 09:32,201603,WESTERN EUROPE-OTHER,FAROE ISLANDS,STANSTED,VAGAR, 0 , 0 , 0 , 532 , 0 , 532 , 0 
05-May-2016 09:32,201603,WESTERN EUROPE-EU,FINLAND,GATWICK,HELSINKI, 19103 , 19103 , 0 , 18340 , 18340 , 0 , 4.16030534351145 
05-May-2016 09:32,201603,WESTERN EUROPE-EU,FINLAND,GATWICK,KITTILA, 176 , 0 , 176 , 1552 , 0 , 1552 ,-88.659793814433 
05-May-2016 09:32,201603,WESTERN EUROPE-EU,FINLAND,HEATHROW,HELSINKI, 56450 , 56450 , 0 , 51573 , 51573 , 0 , 9.45649855544568 
05-May-2016 09:32,201603,WESTERN EUROPE-EU,FINLAND,MANCHESTER,HELSINKI, 8131 , 8131 , 0 , 9014 , 9014 , 0 ,-9.79587308631018 
05-May-2016 09:32,201603,WESTERN EUROPE-EU,FINLAND,MANCHESTER,KITTILA, 1231 , 0 , 1231 , 188 , 0 , 188 , 554.787234042553 
05-May-2016 09:32,201603,WESTERN EUROPE-EU,FINLAND,STANSTED,TAMPERE, 0 , 0 , 0 , 4299 , 4299 , 0 , 0 
05-May-2016 09:32,201603,WESTERN EUROPE-EU,FRANCE,ABERDEEN,PARIS (CHARLES DE GAULLE), 8642 , 8642 , 0 , 7836 , 7836 , 0 , 10.2858601327208 
05-May-2016 09:32,201603,WESTERN EUROPE-EU,FRANCE,BELFAST INTERNATIONAL,LYON, 841 , 841 , 0 , 0 , 0 , 0 , 0 
05-May-2016 09:32,201603,WESTERN EUROPE-EU,FRANCE,BELFAST INTERNATIONAL,NICE, 209 , 209 , 0 , 158 , 158 , 0 , 32.2784810126582 
05-May-2016 09:32,201603,WESTERN EUROPE-EU,FRANCE,BELFAST INTERNATIONAL,PARIS (CHARLES DE GAULLE), 7309 , 7309 , 0 , 8359 , 8359 , 0 ,-12.5613111616222 
05-May-2016 09:32,201603,WESTERN EUROPE-EU,FRANCE,BELFAST INTERNATIONAL,TARBES-LOURDES INTERNATIONAL, 174 , 0 , 174 , 0 , 0 , 0 , 0 
05-May-2016 09:32,201603,WESTERN EUROPE-EU,FRANCE,BELFAST INTERNATIONAL,TOULOUSE (BLAGNAC), 0 , 0 , 0 , 540 , 0 , 540 , 0 
05-May-2016 09:32,201603,WESTERN EUROPE-EU,FRANCE,BIRMINGHAM,BORDEAUX, 350 , 350 , 0 , 179 , 179 , 0 , 95.5307262569832 
05-May-2016 09:32,201603,WESTERN EUROPE-EU,FRANCE,BIRMINGHAM,CHAMBERY, 4983 , 817 , 4166 , 4383 , 876 , 3507 , 13.6892539356605 
05-May-2016 09:32,201603,WESTERN EUROPE-EU,FRANCE,BIRMINGHAM,GRENOBLE, 4398 , 2803 , 1595 , 5311 , 3863 , 1448 ,-17.1907362078705 
05-May-2016 09:32,201603,WESTERN EUROPE-EU,FRANCE,BIRMINGHAM,LYON, 4222 , 4222 , 0 , 3996 , 3996 , 0 , 5.65565565565566 
05-May-2016 09:32,201603,WESTERN EUROPE-EU,FRANCE,BIRMINGHAM,NICE, 0 , 0 , 0 , 283 , 283 , 0 , 0 
05-May-2016 09:32,201603,WESTERN EUROPE-EU,FRANCE,BIRMINGHAM,PARIS (CHARLES DE GAULLE), 35269 , 35269 , 0 , 35414 , 35414 , 0 ,-0.409442593324674 
05-May-2016 09:32,201603,WESTERN EUROPE-EU,FRANCE,BIRMINGHAM,TARBES-LOURDES INTERNATIONAL, 209 , 0 , 209 , 0 , 0 , 0 , 0 
05-May-2016 09:32,201603,WESTERN EUROPE-EU,FRANCE,BIRMINGHAM,TOULOUSE (BLAGNAC), 204 , 0 , 204 , 3213 , 2565 , 648 ,-93.6507936507936 
05-May-2016 09:32,201603,WESTERN EUROPE-EU,FRANCE,BOURNEMOUTH,PARIS (CHARLES DE GAULLE), 410 , 410 , 0 , 0 , 0 , 0 , 0 
05-May-2016 09:32,201603,WESTERN EUROPE-EU,FRANCE,BRISTOL,BERGERAC, 0 , 0 , 0 , 224 , 224 , 0 , 0 
05-May-2016 09:32,201603,WESTERN EUROPE-EU,FRANCE,BRISTOL,BEZIERS, 0 , 0 , 0 , 441 , 441 , 0 , 0 
05-May-2016 09:32,201603,WESTERN EUROPE-EU,FRANCE,BRISTOL,BORDEAUX, 302 , 302 , 0 , 259 , 259 , 0 , 16.6023166023166 
05-May-2016 09:32,201603,WESTERN EUROPE-EU,FRANCE,BRISTOL,CHAMBERY, 2982 , 0 , 2982 , 3224 , 0 , 3224 ,-7.50620347394541 
05-May-2016 09:32,201603,WESTERN EUROPE-EU,FRANCE,BRISTOL,GRENOBLE, 2235 , 2235 , 0 , 2443 , 2443 , 0 ,-8.51412198117069 
05-May-2016 09:32,201603,WESTERN EUROPE-EU,FRANCE,BRISTOL,LIMOGES, 0 , 0 , 0 , 261 , 261 , 0 , 0 
05-May-2016 09:32,201603,WESTERN EUROPE-EU,FRANCE,BRISTOL,LYON, 1181 , 1181 , 0 , 1012 , 1012 , 0 , 16.699604743083 
05-May-2016 09:32,201603,WESTERN EUROPE-EU,FRANCE,BRISTOL,NANTES, 483 , 483 , 0 , 0 , 0 , 0 , 0 
05-May-2016 09:32,201603,WESTERN EUROPE-EU,FRANCE,BRISTOL,NICE, 3298 , 3298 , 0 , 3326 , 3326 , 0 ,-0.841852074564041 
05-May-2016 09:32,201603,WESTERN EUROPE-EU,FRANCE,BRISTOL,PARIS (CHARLES DE GAULLE), 11605 , 11605 , 0 , 10057 , 10057 , 0 , 15.3922640946604 
05-May-2016 09:32,201603,WESTERN EUROPE-EU,FRANCE,BRISTOL,TARBES-LOURDES INTERNATIONAL, 185 , 0 , 185 , 0 , 0 , 0 , 0 
05-May-2016 09:32,201603,WESTERN EUROPE-EU,FRANCE,BRISTOL,TOULOUSE (BLAGNAC), 7352 , 5490 , 1862 , 8920 , 6628 , 2292 ,-17.5784753363229 
05-May-2016 09:32,201603,WESTERN EUROPE-EU,FRANCE,CARDIFF WALES,CHAMBERY, 714 , 714 , 0 , 0 , 0 , 0 , 0 
05-May-2016 09:32,201603,WESTERN EUROPE-EU,FRANCE,CARDIFF WALES,PARIS (CHARLES DE GAULLE), 4798 , 4798 , 0 , 232 , 0 , 232 , 1968.10344827586 
05-May-2016 09:32,201603,WESTERN EUROPE-EU,FRANCE,CARDIFF WALES,PARIS (ORLY), 0 , 0 , 0 , 1891 , 1891 , 0 , 0 
05-May-2016 09:32,201603,WESTERN EUROPE-EU,FRANCE,CARDIFF WALES,TARBES-LOURDES INTERNATIONAL, 183 , 0 , 183 , 0 , 0 , 0 , 0 
05-May-2016 09:32,201603,WESTERN EUROPE-EU,FRANCE,DONCASTER SHEFFIELD,PARIS (CHARLES DE GAULLE), 2124 , 2124 , 0 , 0 , 0 , 0 , 0 
05-May-2016 09:32,201603,WESTERN EUROPE-EU,FRANCE,EAST MIDLANDS INTERNATIONAL,BERGERAC, 0 , 0 , 0 , 246 , 246 , 0 , 0 
05-May-2016 09:32,201603,WESTERN EUROPE-EU,FRANCE,EAST MIDLANDS INTERNATIONAL,CARCASSONNE, 1493 , 1493 , 0 , 217 , 217 , 0 , 588.018433179724 
05-May-2016 09:32,201603,WESTERN EUROPE-EU,FRANCE,EAST MIDLANDS INTERNATIONAL,CHAMBERY, 3246 , 2121 , 1125 , 3396 , 2052 , 1344 ,-4.41696113074205 
05-May-2016 09:32,201603,WESTERN EUROPE-EU,FRANCE,EAST MIDLANDS INTERNATIONAL,DINARD, 0 , 0 , 0 , 470 , 470 , 0 , 0 
05-May-2016 09:32,201603,WESTERN EUROPE-EU,FRANCE,EAST MIDLANDS INTERNATIONAL,LIMOGES, 4257 , 4257 , 0 , 4022 , 4022 , 0 , 5.84286424664346 
05-May-2016 09:32,201603,WESTERN EUROPE-EU,FRANCE,EDINBURGH,BEZIERS, 0 , 0 , 0 , 235 , 235 , 0 , 0 
05-May-2016 09:32,201603,WESTERN EUROPE-EU,FRANCE,EDINBURGH,BORDEAUX, 2509 , 2216 , 293 , 289 , 289 , 0 , 768.166089965398 
05-May-2016 09:32,201603,WESTERN EUROPE-EU,FRANCE,EDINBURGH,CHAMBERY, 1775 , 1041 , 734 , 1805 , 1054 , 751 ,-1.66204986149584 
05-May-2016 09:32,201603,WESTERN EUROPE-EU,FRANCE,EDINBURGH,GRENOBLE, 1811 , 1811 , 0 , 1106 , 1106 , 0 , 63.74321880651 
05-May-2016 09:32,201603,WESTERN EUROPE-EU,FRANCE,EDINBURGH,LYON, 3870 , 2362 , 1508 , 1082 , 1082 , 0 , 257.670979667283 
05-May-2016 09:32,201603,WESTERN EUROPE-EU,FRANCE,EDINBURGH,MARSEILLE, 377 , 377 , 0 , 240 , 240 , 0 , 57.0833333333333 
05-May-2016 09:32,201603,WESTERN EUROPE-EU,FRANCE,EDINBURGH,NANTES, 621 , 0 , 621 , 0 , 0 , 0 , 0 
05-May-2016 09:32,201603,WESTERN EUROPE-EU,FRANCE,EDINBURGH,NICE, 515 , 515 , 0 , 390 , 390 , 0 , 32.0512820512821 
05-May-2016 09:32,201603,WESTERN EUROPE-EU,FRANCE,EDINBURGH,PARIS (CHARLES DE GAULLE), 29306 , 26561 , 2745 , 22327 , 22168 , 159 , 31.2581179737538 
05-May-2016 09:32,201603,WESTERN EUROPE-EU,FRANCE,EDINBURGH,PARIS (ORLY), 1411 , 1025 , 386 , 0 , 0 , 0 , 0 
05-May-2016 09:32,201603,WESTERN EUROPE-EU,FRANCE,EDINBURGH,TOULOUSE (BLAGNAC), 1591 , 0 , 1591 , 294 , 0 , 294 , 441.156462585034 
05-May-2016 09:32,201603,WESTERN EUROPE-EU,FRANCE,EXETER,CHAMBERY, 519 , 519 , 0 , 568 , 568 , 0 ,-8.62676056338028 
05-May-2016 09:32,201603,WESTERN EUROPE-EU,FRANCE,EXETER,PARIS (CHARLES DE GAULLE), 3217 , 3217 , 0 , 3713 , 3713 , 0 ,-13.3584702396984 
05-May-2016 09:32,201603,WESTERN EUROPE-EU,FRANCE,GATWICK,BORDEAUX, 19455 , 19455 , 0 , 18830 , 18830 , 0 , 3.31917153478492 
05-May-2016 09:32,201603,WESTERN EUROPE-EU,FRANCE,GATWICK,CHAMBERY, 12165 , 0 , 12165 , 12771 , 0 , 12771 ,-4.74512567535823 
05-May-2016 09:32,201603,WESTERN EUROPE-EU,FRANCE,GATWICK,GRENOBLE, 31465 , 14816 , 16649 , 31907 , 9260 , 22647 ,-1.38527595825367 
05-May-2016 09:32,201603,WESTERN EUROPE-EU,FRANCE,GATWICK,LE HAVRE, 202 , 0 , 202 , 0 , 0 , 0 , 0 
05-May-2016 09:32,201603,WESTERN EUROPE-EU,FRANCE,GATWICK,LYON, 24226 , 17531 , 6695 , 24962 , 17976 , 6986 ,-2.9484816921721 
05-May-2016 09:32,201603,WESTERN EUROPE-EU,FRANCE,GATWICK,MARSEILLE, 10399 , 10399 , 0 , 11338 , 11338 , 0 ,-8.28188393014641 
05-May-2016 09:32,201603,WESTERN EUROPE-EU,FRANCE,GATWICK,MONTPELLIER, 7972 , 7972 , 0 , 8858 , 8858 , 0 ,-10.0022578460149 
05-May-2016 09:32,201603,WESTERN EUROPE-EU,FRANCE,GATWICK,NANTES, 9237 , 9237 , 0 , 7041 , 7041 , 0 , 31.1887515977844 
05-May-2016 09:32,201603,WESTERN EUROPE-EU,FRANCE,GATWICK,NICE, 42609 , 42609 , 0 , 42582 , 42582 , 0 , 6.34070734113005E-02 
05-May-2016 09:32,201603,WESTERN EUROPE-EU,FRANCE,GATWICK,PARIS (CHARLES DE GAULLE), 19498 , 19498 , 0 , 16619 , 16603 , 16 , 17.3235453396715 
05-May-2016 09:32,201603,WESTERN EUROPE-EU,FRANCE,GATWICK,STRASBOURG, 2981 , 2981 , 0 , 4181 , 4181 , 0 ,-28.7012676393207 
05-May-2016 09:32,201603,WESTERN EUROPE-EU,FRANCE,GATWICK,TARBES-LOURDES INTERNATIONAL, 1151 , 0 , 1151 , 0 , 0 , 0 , 0 
05-May-2016 09:32,201603,WESTERN EUROPE-EU,FRANCE,GATWICK,TOULOUSE (BLAGNAC), 20916 , 19230 , 1686 , 23009 , 20847 , 2162 ,-9.0964405232735 
05-May-2016 09:32,201603,WESTERN EUROPE-EU,FRANCE,GLASGOW,CHAMBERY, 1593 , 0 , 1593 , 1632 , 0 , 1632 ,-2.38970588235294 
05-May-2016 09:32,201603,WESTERN EUROPE-EU,FRANCE,GLASGOW,PARIS (CHARLES DE GAULLE), 9833 , 9833 , 0 , 8245 , 8209 , 36 , 19.260157671316 
05-May-2016 09:32,201603,WESTERN EUROPE-EU,FRANCE,GLASGOW,PARIS (LE BOURGET), 131 , 0 , 131 , 35 , 0 , 35 , 274.285714285714 
05-May-2016 09:32,201603,WESTERN EUROPE-EU,FRANCE,GLASGOW,TARBES-LOURDES INTERNATIONAL, 359 , 0 , 359 , 0 , 0 , 0 , 0 
05-May-2016 09:32,201603,WESTERN EUROPE-EU,FRANCE,GUERNSEY,DINARD, 279 , 279 , 0 , 201 , 201 , 0 , 38.8059701492537 
05-May-2016 09:32,201603,WESTERN EUROPE-EU,FRANCE,HEATHROW,GRENOBLE, 1377 , 0 , 1377 , 1684 , 0 , 1684 ,-18.2304038004751 
05-May-2016 09:32,201603,WESTERN EUROPE-EU,FRANCE,HEATHROW,LYON, 22205 , 22205 , 0 , 18773 , 18773 , 0 , 18.2815746018218 
05-May-2016 09:32,201603,WESTERN EUROPE-EU,FRANCE,HEATHROW,MARSEILLE, 19340 , 19340 , 0 , 17308 , 17308 , 0 , 11.7402357291426 
05-May-2016 09:32,201603,WESTERN EUROPE-EU,FRANCE,HEATHROW,NICE, 33740 , 33740 , 0 , 34147 , 34147 , 0 ,-1.19190558467801 
05-May-2016 09:32,201603,WESTERN EUROPE-EU,FRANCE,HEATHROW,PARIS (CHARLES DE GAULLE), 99089 , 99089 , 0 , 93741 , 93741 , 0 , 5.70508102111136 
05-May-2016 09:32,201603,WESTERN EUROPE-EU,FRANCE,HEATHROW,PARIS (ORLY), 24608 , 24608 , 0 , 25512 , 25512 , 0 ,-3.54343054248981 
05-May-2016 09:32,201603,WESTERN EUROPE-EU,FRANCE,HEATHROW,TOULOUSE (BLAGNAC), 22340 , 22340 , 0 , 20766 , 20766 , 0 , 7.57969758258692 
05-May-2016 09:32,201603,WESTERN EUROPE-EU,FRANCE,LEEDS BRADFORD,CHAMBERY, 1607 , 1607 , 0 , 1698 , 1698 , 0 ,-5.35924617196702 
05-May-2016 09:32,201603,WESTERN EUROPE-EU,FRANCE,LEEDS BRADFORD,LIMOGES, 0 , 0 , 0 , 250 , 250 , 0 , 0 
05-May-2016 09:32,201603,WESTERN EUROPE-EU,FRANCE,LEEDS BRADFORD,PARIS (CHARLES DE GAULLE), 3857 , 3857 , 0 , 3972 , 3972 , 0 ,-2.89526686807654 
05-May-2016 09:32,201603,WESTERN EUROPE-EU,FRANCE,LEEDS BRADFORD,PERPIGNAN, 78 , 0 , 78 , 295 , 0 , 295 ,-73.5593220338983 
05-May-2016 09:32,201603,WESTERN EUROPE-EU,FRANCE,LIVERPOOL (JOHN LENNON),BERGERAC, 1143 , 1143 , 0 , 232 , 232 , 0 , 392.672413793103 
05-May-2016 09:32,201603,WESTERN EUROPE-EU,FRANCE,LIVERPOOL (JOHN LENNON),CARCASSONNE, 2760 , 2760 , 0 , 2882 , 2882 , 0 ,-4.23317140874393 
05-May-2016 09:32,201603,WESTERN EUROPE-EU,FRANCE,LIVERPOOL (JOHN LENNON),GRENOBLE, 961 , 961 , 0 , 775 , 775 , 0 , 24 
05-May-2016 09:32,201603,WESTERN EUROPE-EU,FRANCE,LIVERPOOL (JOHN LENNON),LIMOGES, 2031 , 2031 , 0 , 2944 , 2944 , 0 ,-31.0122282608696 
05-May-2016 09:32,201603,WESTERN EUROPE-EU,FRANCE,LIVERPOOL (JOHN LENNON),NICE, 6520 , 6520 , 0 , 5746 , 5746 , 0 , 13.4702401670727 
05-May-2016 09:32,201603,WESTERN EUROPE-EU,FRANCE,LIVERPOOL (JOHN LENNON),PARIS (CHARLES DE GAULLE), 6220 , 6220 , 0 , 7204 , 7204 , 0 ,-13.659078289839 
05-May-2016 09:32,201603,WESTERN EUROPE-EU,FRANCE,LONDON CITY,ANGERS- MARCE, 63 , 63 , 0 , 0 , 0 , 0 , 0 
05-May-2016 09:32,201603,WESTERN EUROPE-EU,FRANCE,LONDON CITY,BRIVE-LA-GAILLARDE, 0 , 0 , 0 , 45 , 45 , 0 , 0 
05-May-2016 09:32,201603,WESTERN EUROPE-EU,FRANCE,LONDON CITY,CHAMBERY, 1174 , 1174 , 0 , 1289 , 1289 , 0 ,-8.92164468580295 
05-May-2016 09:32,201603,WESTERN EUROPE-EU,FRANCE,LONDON CITY,NANTES, 1967 , 1967 , 0 , 1446 , 1446 , 0 , 36.030428769018 
05-May-2016 09:32,201603,WESTERN EUROPE-EU,FRANCE,LONDON CITY,NICE, 3008 , 3008 , 0 , 2980 , 2980 , 0 , 0.939597315436242 
05-May-2016 09:32,201603,WESTERN EUROPE-EU,FRANCE,LONDON CITY,PARIS (CHARLES DE GAULLE), 414 , 414 , 0 , 0 , 0 , 0 , 0 
05-May-2016 09:32,201603,WESTERN EUROPE-EU,FRANCE,LONDON CITY,PARIS (ORLY), 9366 , 9366 , 0 , 10074 , 10074 , 0 ,-7.02799285288862 
05-May-2016 09:32,201603,WESTERN EUROPE-EU,FRANCE,LUTON,BEZIERS, 3822 , 3822 , 0 , 2838 , 2838 , 0 , 34.6723044397463 
05-May-2016 09:32,201603,WESTERN EUROPE-EU,FRANCE,LUTON,BORDEAUX, 4318 , 4318 , 0 , 5125 , 5125 , 0 ,-15.7463414634146 
05-May-2016 09:32,201603,WESTERN EUROPE-EU,FRANCE,LUTON,GRENOBLE, 1168 , 1168 , 0 , 1269 , 1269 , 0 ,-7.95902285263987 
05-May-2016 09:32,201603,WESTERN EUROPE-EU,FRANCE,LUTON,LYON, 9322 , 9322 , 0 , 8334 , 8334 , 0 , 11.8550515958723 
05-May-2016 09:32,201603,WESTERN EUROPE-EU,FRANCE,LUTON,NICE, 9581 , 9473 , 108 , 10531 , 10011 , 520 ,-9.02098566138068 
05-May-2016 09:32,201603,WESTERN EUROPE-EU,FRANCE,LUTON,NIMES, 4039 , 4039 , 0 , 3380 , 3380 , 0 , 19.4970414201183 
05-May-2016 09:32,201603,WESTERN EUROPE-EU,FRANCE,LUTON,PARIS (CHARLES DE GAULLE), 21606 , 21606 , 0 , 23530 , 23530 , 0 ,-8.1767955801105 
05-May-2016 09:32,201603,WESTERN EUROPE-EU,FRANCE,LUTON,PARIS (LE BOURGET), 20 , 0 , 20 , 58 , 0 , 58 ,-65.5172413793103 
05-May-2016 09:32,201603,WESTERN EUROPE-EU,FRANCE,LYDD,CHAMBERY, 19 , 0 , 19 , 0 , 0 , 0 , 0 
05-May-2016 09:32,201603,WESTERN EUROPE-EU,FRANCE,MANCHESTER,BEAUVAIS, 1943 , 1943 , 0 , 311 , 311 , 0 , 524.75884244373 
05-May-2016 09:32,201603,WESTERN EUROPE-EU,FRANCE,MANCHESTER,BERGERAC, 50 , 50 , 0 , 0 , 0 , 0 , 0 
05-May-2016 09:32,201603,WESTERN EUROPE-EU,FRANCE,MANCHESTER,BEZIERS, 0 , 0 , 0 , 243 , 243 , 0 , 0 
05-May-2016 09:32,201603,WESTERN EUROPE-EU,FRANCE,MANCHESTER,CHAMBERY, 6328 , 3531 , 2797 , 6947 , 3935 , 3012 ,-8.91032100187131 
05-May-2016 09:32,201603,WESTERN EUROPE-EU,FRANCE,MANCHESTER,GRENOBLE, 9072 , 8081 , 991 , 9066 , 3342 , 5724 , 6.61813368630046E-02 
05-May-2016 09:32,201603,WESTERN EUROPE-EU,FRANCE,MANCHESTER,LYON, 3740 , 3576 , 164 , 2968 , 1756 , 1212 , 26.010781671159 
05-May-2016 09:32,201603,WESTERN EUROPE-EU,FRANCE,MANCHESTER,MARSEILLE, 2062 , 2062 , 0 , 0 , 0 , 0 , 0 
05-May-2016 09:32,201603,WESTERN EUROPE-EU,FRANCE,MANCHESTER,NANTES, 613 , 613 , 0 , 1091 , 1091 , 0 ,-43.8130155820348 
05-May-2016 09:32,201603,WESTERN EUROPE-EU,FRANCE,MANCHESTER,NICE, 1611 , 1611 , 0 , 496 , 496 , 0 , 224.798387096774 
05-May-2016 09:32,201603,WESTERN EUROPE-EU,FRANCE,MANCHESTER,PARIS (CHARLES DE GAULLE), 45013 , 45013 , 0 , 43739 , 43739 , 0 , 2.91273234413224 
05-May-2016 09:32,201603,WESTERN EUROPE-EU,FRANCE,MANCHESTER,PERPIGNAN, 198 , 0 , 198 , 0 , 0 , 0 , 0 
05-May-2016 09:32,201603,WESTERN EUROPE-EU,FRANCE,MANCHESTER,TARBES-LOURDES INTERNATIONAL, 701 , 0 , 701 , 0 , 0 , 0 , 0 
05-May-2016 09:32,201603,WESTERN EUROPE-EU,FRANCE,MANCHESTER,TOULOUSE (BLAGNAC), 1435 , 0 , 1435 , 1846 , 0 , 1846 ,-22.2643553629469 
05-May-2016 09:32,201603,WESTERN EUROPE-EU,FRANCE,NEWCASTLE,CHAMBERY, 1060 , 1060 , 0 , 1072 , 1072 , 0 ,-1.11940298507463 
05-May-2016 09:32,201603,WESTERN EUROPE-EU,FRANCE,NEWCASTLE,NICE, 0 , 0 , 0 , 184 , 184 , 0 , 0 
05-May-2016 09:32,201603,WESTERN EUROPE-EU,FRANCE,NEWCASTLE,PARIS (CHARLES DE GAULLE), 12700 , 12700 , 0 , 12900 , 12900 , 0 ,-1.55038759689922 
05-May-2016 09:32,201603,WESTERN EUROPE-EU,FRANCE,NEWCASTLE,TARBES-LOURDES INTERNATIONAL, 258 , 0 , 258 , 0 , 0 , 0 , 0 
05-May-2016 09:32,201603,WESTERN EUROPE-EU,FRANCE,SOUTHAMPTON,BERGERAC, 2288 , 2288 , 0 , 1850 , 1850 , 0 , 23.6756756756757 
05-May-2016 09:32,201603,WESTERN EUROPE-EU,FRANCE,SOUTHAMPTON,CHAMBERY, 2575 , 1400 , 1175 , 1455 , 1455 , 0 , 76.9759450171821 
05-May-2016 09:32,201603,WESTERN EUROPE-EU,FRANCE,SOUTHAMPTON,GRENOBLE, 0 , 0 , 0 , 536 , 536 , 0 , 0 
05-May-2016 09:32,201603,WESTERN EUROPE-EU,FRANCE,SOUTHAMPTON,LA ROCHELLE, 190 , 190 , 0 , 549 , 549 , 0 ,-65.3916211293261 
05-May-2016 09:32,201603,WESTERN EUROPE-EU,FRANCE,SOUTHAMPTON,LIMOGES, 0 , 0 , 0 , 1377 , 1377 , 0 , 0 
05-May-2016 09:32,201603,WESTERN EUROPE-EU,FRANCE,SOUTHAMPTON,NANTES, 1734 , 1734 , 0 , 1852 , 1852 , 0 ,-6.37149028077754 
05-May-2016 09:32,201603,WESTERN EUROPE-EU,FRANCE,SOUTHAMPTON,PARIS (CHARLES DE GAULLE), 433 , 433 , 0 , 0 , 0 , 0 , 0 
05-May-2016 09:32,201603,WESTERN EUROPE-EU,FRANCE,SOUTHAMPTON,PARIS (ORLY), 5800 , 5800 , 0 , 6604 , 6604 , 0 ,-12.1744397334949 
05-May-2016 09:32,201603,WESTERN EUROPE-EU,FRANCE,SOUTHAMPTON,RENNES, 420 , 420 , 0 , 1513 , 1513 , 0 ,-72.2405816259088 
05-May-2016 09:32,201603,WESTERN EUROPE-EU,FRANCE,SOUTHEND,CAEN, 809 , 809 , 0 , 418 , 418 , 0 , 93.5406698564593 
05-May-2016 09:32,201603,WESTERN EUROPE-EU,FRANCE,SOUTHEND,LYON, 943 , 943 , 0 , 0 , 0 , 0 , 0 
05-May-2016 09:32,201603,WESTERN EUROPE-EU,FRANCE,SOUTHEND,NANTES, 25 , 25 , 0 , 0 , 0 , 0 , 0 
05-May-2016 09:32,201603,WESTERN EUROPE-EU,FRANCE,SOUTHEND,PARIS (CHARLES DE GAULLE), 3149 , 3149 , 0 , 0 , 0 , 0 , 0 
05-May-2016 09:32,201603,WESTERN EUROPE-EU,FRANCE,SOUTHEND,RENNES, 3140 , 3140 , 0 , 2279 , 2279 , 0 , 37.7797279508556 
05-May-2016 09:32,201603,WESTERN EUROPE-EU,FRANCE,STANSTED,BERGERAC, 5085 , 5085 , 0 , 4675 , 4675 , 0 , 8.77005347593583 
05-May-2016 09:32,201603,WESTERN EUROPE-EU,FRANCE,STANSTED,BIARRITZ, 6504 , 6504 , 0 , 5080 , 5080 , 0 , 28.0314960629921 
05-May-2016 09:32,201603,WESTERN EUROPE-EU,FRANCE,STANSTED,BORDEAUX, 3582 , 3582 , 0 , 3214 , 3214 , 0 , 11.4499066583696 
05-May-2016 09:32,201603,WESTERN EUROPE-EU,FRANCE,STANSTED,CARCASSONNE, 6218 , 6218 , 0 , 4500 , 4500 , 0 , 38.1777777777778 
05-May-2016 09:32,201603,WESTERN EUROPE-EU,FRANCE,STANSTED,CHAMBERY, 4303 , 0 , 4303 , 5159 , 0 , 5159 ,-16.5923628610196 
05-May-2016 09:32,201603,WESTERN EUROPE-EU,FRANCE,STANSTED,DINARD, 4569 , 4569 , 0 , 5857 , 5857 , 0 ,-21.9907802629332 
05-May-2016 09:32,201603,WESTERN EUROPE-EU,FRANCE,STANSTED,GRENOBLE, 5077 , 4336 , 741 , 4259 , 3858 , 401 , 19.2063864756985 
05-May-2016 09:32,201603,WESTERN EUROPE-EU,FRANCE,STANSTED,LA ROCHELLE, 4137 , 4137 , 0 , 3976 , 3976 , 0 , 4.04929577464789 
05-May-2016 09:32,201603,WESTERN EUROPE-EU,FRANCE,STANSTED,LIMOGES, 6500 , 6500 , 0 , 5945 , 5945 , 0 , 9.33557611438183 
05-May-2016 09:32,201603,WESTERN EUROPE-EU,FRANCE,STANSTED,MARSEILLE, 10044 , 10044 , 0 , 9725 , 9725 , 0 , 3.28020565552699 
05-May-2016 09:32,201603,WESTERN EUROPE-EU,FRANCE,STANSTED,NICE, 5103 , 5103 , 0 , 5574 , 5574 , 0 ,-8.44994617868676 
05-May-2016 09:32,201603,WESTERN EUROPE-EU,FRANCE,STANSTED,PARIS (ORLY), 44 , 44 , 0 , 0 , 0 , 0 , 0 
05-May-2016 09:32,201603,WESTERN EUROPE-EU,FRANCE,STANSTED,PERPIGNAN, 2044 , 2044 , 0 , 4153 , 4153 , 0 ,-50.7825668191669 
05-May-2016 09:32,201603,WESTERN EUROPE-EU,FRANCE,STANSTED,POITIERS, 3058 , 3058 , 0 , 3297 , 3297 , 0 ,-7.24901425538368 
05-May-2016 09:32,201603,WESTERN EUROPE-EU,FRANCE,STANSTED,RODEZ, 0 , 0 , 0 , 207 , 207 , 0 , 0 
05-May-2016 09:32,201603,WESTERN EUROPE-EU,FRANCE,STANSTED,STRASBOURG, 0 , 0 , 0 , 371 , 371 , 0 , 0 
05-May-2016 09:32,201603,WESTERN EUROPE-EU,FRANCE,STANSTED,TARBES-LOURDES INTERNATIONAL, 3988 , 3844 , 144 , 2843 , 2843 , 0 , 40.2743580724587 
05-May-2016 09:32,201603,WESTERN EUROPE-EU,FRANCE,STANSTED,TOURS, 3847 , 3847 , 0 , 3141 , 3141 , 0 , 22.4769181789239 
05-May-2016 09:32,201603,WEST AFRICA,GAMBIA,BIRMINGHAM,BANJUL, 1323 , 1323 , 0 , 1387 , 0 , 1387 ,-4.61427541456381 
05-May-2016 09:32,201603,WEST AFRICA,GAMBIA,GATWICK,BANJUL, 7512 , 4980 , 2532 , 5325 , 0 , 5325 , 41.0704225352113 
05-May-2016 09:32,201603,WEST AFRICA,GAMBIA,MANCHESTER,BANJUL, 5208 , 5208 , 0 , 3237 , 0 , 3237 , 60.8897126969416 
05-May-2016 09:32,201603,WESTERN EUROPE-EU,GERMANY,ABERDEEN,DUSSELDORF, 0 , 0 , 0 , 95 , 0 , 95 , 0 
05-May-2016 09:32,201603,WESTERN EUROPE-EU,GERMANY,ABERDEEN,FRANKFURT MAIN, 8647 , 8647 , 0 , 8483 , 8483 , 0 , 1.93327832134858 
05-May-2016 09:32,201603,WESTERN EUROPE-EU,GERMANY,BIRMINGHAM,BERLIN (SCHONEFELD), 180 , 0 , 180 , 0 , 0 , 0 , 0 
05-May-2016 09:32,201603,WESTERN EUROPE-EU,GERMANY,BIRMINGHAM,BERLIN (TEGEL), 4539 , 4539 , 0 , 4045 , 4045 , 0 , 12.21260815822 
05-May-2016 09:32,201603,WESTERN EUROPE-EU,GERMANY,BIRMINGHAM,COLOGNE BONN, 0 , 0 , 0 , 2348 , 2348 , 0 , 0 
05-May-2016 09:32,201603,WESTERN EUROPE-EU,GERMANY,BIRMINGHAM,DUSSELDORF, 20268 , 20268 , 0 , 17913 , 17913 , 0 , 13.1468765700888 
05-May-2016 09:32,201603,WESTERN EUROPE-EU,GERMANY,BIRMINGHAM,FRANKFURT MAIN, 27300 , 27300 , 0 , 24529 , 24529 , 0 , 11.2968323209263 
05-May-2016 09:32,201603,WESTERN EUROPE-EU,GERMANY,BIRMINGHAM,HAHN, 44 , 0 , 44 , 0 , 0 , 0 , 0 
05-May-2016 09:32,201603,WESTERN EUROPE-EU,GERMANY,BIRMINGHAM,HAMBURG, 2317 , 2317 , 0 , 5161 , 5161 , 0 ,-55.1055996899826 
05-May-2016 09:32,201603,WESTERN EUROPE-EU,GERMANY,BIRMINGHAM,HANOVER, 4061 , 4061 , 0 , 5891 , 4629 , 1262 ,-31.0643354269224 
05-May-2016 09:32,201603,WESTERN EUROPE-EU,GERMANY,BIRMINGHAM,MUNICH, 16591 , 16591 , 0 , 15477 , 15477 , 0 , 7.19777734703108 
05-May-2016 09:32,201603,WESTERN EUROPE-EU,GERMANY,BIRMINGHAM,PADERBORN, 1118 , 102 , 1016 , 1128 , 0 , 1128 ,-0.886524822695036 
05-May-2016 09:32,201603,WESTERN EUROPE-EU,GERMANY,BIRMINGHAM,STUTTGART, 6262 , 6262 , 0 , 6526 , 6526 , 0 ,-4.04535703340484 
05-May-2016 09:32,201603,WESTERN EUROPE-EU,GERMANY,BRISTOL,BERLIN (SCHONEFELD), 6725 , 6725 , 0 , 6185 , 6185 , 0 , 8.73080032336297 
05-May-2016 09:32,201603,WESTERN EUROPE-EU,GERMANY,BRISTOL,DUSSELDORF, 868 , 868 , 0 , 0 , 0 , 0 , 0 
05-May-2016 09:32,201603,WESTERN EUROPE-EU,GERMANY,BRISTOL,FRANKFURT MAIN, 3441 , 3441 , 0 , 3573 , 3573 , 0 ,-3.6943744752309 
05-May-2016 09:32,201603,WESTERN EUROPE-EU,GERMANY,BRISTOL,HAMBURG, 1030 , 1030 , 0 , 1897 , 1897 , 0 ,-45.7037427517132 
05-May-2016 09:32,201603,WESTERN EUROPE-EU,GERMANY,BRISTOL,HANOVER, 23 , 0 , 23 , 0 , 0 , 0 , 0 
05-May-2016 09:32,201603,WESTERN EUROPE-EU,GERMANY,BRISTOL,MUNICH, 2603 , 2603 , 0 , 2152 , 2152 , 0 , 20.957249070632 
05-May-2016 09:32,201603,WESTERN EUROPE-EU,GERMANY,CARDIFF WALES,MUNICH, 1457 , 1457 , 0 , 0 , 0 , 0 , 0 
05-May-2016 09:32,201603,WESTERN EUROPE-EU,GERMANY,DONCASTER SHEFFIELD,BERLIN (TEGEL), 706 , 706 , 0 , 0 , 0 , 0 , 0 
05-May-2016 09:32,201603,WESTERN EUROPE-EU,GERMANY,DURHAM TEES VALLEY,COLOGNE BONN, 0 , 0 , 0 , 8 , 0 , 8 , 0 
05-May-2016 09:32,201603,WESTERN EUROPE-EU,GERMANY,DURHAM TEES VALLEY,DUSSELDORF, 0 , 0 , 0 , 40 , 0 , 40 , 0 
05-May-2016 09:32,201603,WESTERN EUROPE-EU,GERMANY,DURHAM TEES VALLEY,PADERBORN, 0 , 0 , 0 , 48 , 0 , 48 , 0 
05-May-2016 09:32,201603,WESTERN EUROPE-EU,GERMANY,EAST MIDLANDS INTERNATIONAL,BERLIN (SCHONEFELD), 4285 , 4285 , 0 , 4104 , 4104 , 0 , 4.41033138401559 
05-May-2016 09:32,201603,WESTERN EUROPE-EU,GERMANY,EAST MIDLANDS INTERNATIONAL,DUSSELDORF, 610 , 610 , 0 , 0 , 0 , 0 , 0 
05-May-2016 09:32,201603,WESTERN EUROPE-EU,GERMANY,EDINBURGH,BERLIN (SCHONEFELD), 4694 , 4694 , 0 , 3819 , 3819 , 0 , 22.9117570044514 
05-May-2016 09:32,201603,WESTERN EUROPE-EU,GERMANY,EDINBURGH,BREMEN, 0 , 0 , 0 , 312 , 312 , 0 , 0 
05-May-2016 09:32,201603,WESTERN EUROPE-EU,GERMANY,EDINBURGH,COLOGNE BONN, 2347 , 2347 , 0 , 2000 , 2000 , 0 , 17.35 
05-May-2016 09:32,201603,WESTERN EUROPE-EU,GERMANY,EDINBURGH,DUSSELDORF, 927 , 927 , 0 , 0 , 0 , 0 , 0 
05-May-2016 09:32,201603,WESTERN EUROPE-EU,GERMANY,EDINBURGH,FRANKFURT MAIN, 14232 , 14232 , 0 , 12152 , 12152 , 0 , 17.1165240289664 
05-May-2016 09:32,201603,WESTERN EUROPE-EU,GERMANY,EDINBURGH,HAHN, 3190 , 3190 , 0 , 308 , 308 , 0 , 935.714285714286 
05-May-2016 09:32,201603,WESTERN EUROPE-EU,GERMANY,EDINBURGH,HAMBURG, 5194 , 5194 , 0 , 5407 , 5407 , 0 ,-3.93933789532088 
05-May-2016 09:32,201603,WESTERN EUROPE-EU,GERMANY,EDINBURGH,MUNICH, 9534 , 9534 , 0 , 7167 , 7167 , 0 , 33.0263708664713 
05-May-2016 09:32,201603,WESTERN EUROPE-EU,GERMANY,EDINBURGH,NIEDERRHEIN, 4634 , 4634 , 0 , 4091 , 4091 , 0 , 13.273038376925 
05-May-2016 09:32,201603,WESTERN EUROPE-EU,GERMANY,EDINBURGH,STUTTGART, 4032 , 4032 , 0 , 0 , 0 , 0 , 0 
05-May-2016 09:32,201603,WESTERN EUROPE-EU,GERMANY,GATWICK,BERLIN (SCHONEFELD), 53248 , 53248 , 0 , 47011 , 47011 , 0 , 13.2671076981983 
05-May-2016 09:32,201603,WESTERN EUROPE-EU,GERMANY,GATWICK,COLOGNE BONN, 2870 , 2870 , 0 , 11118 , 11118 , 0 ,-74.1860046771002 
05-May-2016 09:32,201603,WESTERN EUROPE-EU,GERMANY,GATWICK,DUSSELDORF, 4069 , 3946 , 123 , 10570 , 10570 , 0 ,-61.5042573320719 
05-May-2016 09:32,201603,WESTERN EUROPE-EU,GERMANY,GATWICK,ERFURT, 0 , 0 , 0 , 691 , 691 , 0 , 0 
05-May-2016 09:32,201603,WESTERN EUROPE-EU,GERMANY,GATWICK,FRIEDRICHSHAFEN, 6409 , 3094 , 3315 , 5232 , 3138 , 2094 , 22.4961773700306 
05-May-2016 09:32,201603,WESTERN EUROPE-EU,GERMANY,GATWICK,HAMBURG, 14812 , 14812 , 0 , 16590 , 16590 , 0 ,-10.7172995780591 
05-May-2016 09:32,201603,WESTERN EUROPE-EU,GERMANY,GATWICK,MUNICH, 20558 , 20558 , 0 , 16771 , 16771 , 0 , 22.5806451612903 
05-May-2016 09:32,201603,WESTERN EUROPE-EU,GERMANY,GATWICK,STUTTGART, 10198 , 10198 , 0 , 1123 , 1123 , 0 , 808.103294746216 
05-May-2016 09:32,201603,WESTERN EUROPE-EU,GERMANY,GLASGOW,BERLIN (SCHONEFELD), 14118 , 14118 , 0 , 5953 , 5953 , 0 , 137.157735595498 
05-May-2016 09:32,201603,WESTERN EUROPE-EU,GERMANY,GLASGOW,DUSSELDORF, 2230 , 2230 , 0 , 2198 , 2198 , 0 , 1.45586897179254 
05-May-2016 09:32,201603,WESTERN EUROPE-EU,GERMANY,HEATHROW,BERLIN (TEGEL), 70107 , 70107 , 0 , 66759 , 66759 , 0 , 5.01505415000225 
05-May-2016 09:32,201603,WESTERN EUROPE-EU,GERMANY,HEATHROW,COLOGNE BONN, 16275 , 16275 , 0 , 12105 , 12105 , 0 , 34.4485749690211 
05-May-2016 09:32,201603,WESTERN EUROPE-EU,GERMANY,HEATHROW,DUSSELDORF, 57299 , 57299 , 0 , 50624 , 50624 , 0 , 13.1854456384324 
05-May-2016 09:32,201603,WESTERN EUROPE-EU,GERMANY,HEATHROW,FRANKFURT MAIN, 118805 , 118805 , 0 , 117119 , 117119 , 0 , 1.43956147166557 
05-May-2016 09:32,201603,WESTERN EUROPE-EU,GERMANY,HEATHROW,HAMBURG, 49820 , 49820 , 0 , 46751 , 46751 , 0 , 6.56456546384035 
05-May-2016 09:32,201603,WESTERN EUROPE-EU,GERMANY,HEATHROW,HANOVER, 18511 , 18511 , 0 , 16883 , 16883 , 0 , 9.64283598886454 
05-May-2016 09:32,201603,WESTERN EUROPE-EU,GERMANY,HEATHROW,MUNICH, 98300 , 98300 , 0 , 97398 , 97398 , 0 , 0.926097045113863 
05-May-2016 09:32,201603,WESTERN EUROPE-EU,GERMANY,HEATHROW,STUTTGART, 26269 , 26269 , 0 , 28311 , 28311 , 0 ,-7.21274416304617 
05-May-2016 09:32,201603,WESTERN EUROPE-EU,GERMANY,LEEDS BRADFORD,COLOGNE BONN, 0 , 0 , 0 , 44 , 44 , 0 , 0 
05-May-2016 09:32,201603,WESTERN EUROPE-EU,GERMANY,LEEDS BRADFORD,DUSSELDORF, 4047 , 4047 , 0 , 4310 , 4310 , 0 ,-6.10208816705336 
05-May-2016 09:32,201603,WESTERN EUROPE-EU,GERMANY,LIVERPOOL (JOHN LENNON),BERLIN (SCHONEFELD), 6243 , 6243 , 0 , 7098 , 7098 , 0 ,-12.0456466610313 
05-May-2016 09:32,201603,WESTERN EUROPE-EU,GERMANY,LIVERPOOL (JOHN LENNON),DORTMUND, 84 , 0 , 84 , 0 , 0 , 0 , 0 
05-May-2016 09:32,201603,WESTERN EUROPE-EU,GERMANY,LONDON CITY,DRESDEN, 0 , 0 , 0 , 1440 , 1440 , 0 , 0 
05-May-2016 09:32,201603,WESTERN EUROPE-EU,GERMANY,LONDON CITY,DUSSELDORF, 4558 , 4558 , 0 , 5848 , 5848 , 0 ,-22.0588235294118 
05-May-2016 09:32,201603,WESTERN EUROPE-EU,GERMANY,LONDON CITY,FRANKFURT MAIN, 19374 , 19374 , 0 , 20666 , 20666 , 0 ,-6.2518145746637 
05-May-2016 09:32,201603,WESTERN EUROPE-EU,GERMANY,LONDON CITY,HAMBURG, 815 , 815 , 0 , 966 , 966 , 0 ,-15.6314699792961 
05-May-2016 09:32,201603,WESTERN EUROPE-EU,GERMANY,LUTON,BERLIN (SCHONEFELD), 15022 , 14965 , 57 , 15776 , 15776 , 0 ,-4.77941176470588 
05-May-2016 09:32,201603,WESTERN EUROPE-EU,GERMANY,LUTON,DORTMUND, 7657 , 7657 , 0 , 11271 , 11271 , 0 ,-32.0645905420992 
05-May-2016 09:32,201603,WESTERN EUROPE-EU,GERMANY,LUTON,DUSSELDORF, 5 , 0 , 5 , 0 , 0 , 0 , 0 
05-May-2016 09:32,201603,WESTERN EUROPE-EU,GERMANY,LUTON,FRIEDRICHSHAFEN, 8 , 0 , 8 , 157 , 0 , 157 ,-94.9044585987261 
05-May-2016 09:32,201603,WESTERN EUROPE-EU,GERMANY,LUTON,HAMBURG, 7714 , 7714 , 0 , 6326 , 6326 , 0 , 21.9411950679734 
05-May-2016 09:32,201603,WESTERN EUROPE-EU,GERMANY,LUTON,MUNICH, 6051 , 6051 , 0 , 5039 , 5039 , 0 , 20.0833498710061 
05-May-2016 09:32,201603,WESTERN EUROPE-EU,GERMANY,MANCHESTER,BERLIN (SCHONEFELD), 12358 , 12358 , 0 , 6762 , 6762 , 0 , 82.7565808932269 
05-May-2016 09:32,201603,WESTERN EUROPE-EU,GERMANY,MANCHESTER,BREMEN, 2690 , 2690 , 0 , 3317 , 3317 , 0 ,-18.9026228519747 
05-May-2016 09:32,201603,WESTERN EUROPE-EU,GERMANY,MANCHESTER,COLOGNE BONN, 4385 , 4385 , 0 , 4514 , 4514 , 0 ,-2.85777580859548 
05-May-2016 09:32,201603,WESTERN EUROPE-EU,GERMANY,MANCHESTER,DUSSELDORF, 16950 , 16950 , 0 , 14612 , 14612 , 0 , 16.0005474952094 
05-May-2016 09:32,201603,WESTERN EUROPE-EU,GERMANY,MANCHESTER,FRANKFURT MAIN, 33900 , 33658 , 242 , 31125 , 31125 , 0 , 8.91566265060241 
05-May-2016 09:32,201603,WESTERN EUROPE-EU,GERMANY,MANCHESTER,FRIEDRICHSHAFEN, 0 , 0 , 0 , 207 , 207 , 0 , 0 
05-May-2016 09:32,201603,WESTERN EUROPE-EU,GERMANY,MANCHESTER,HAMBURG, 11303 , 11303 , 0 , 10986 , 10986 , 0 , 2.88549062443109 
05-May-2016 09:32,201603,WESTERN EUROPE-EU,GERMANY,MANCHESTER,HANOVER, 4420 , 4420 , 0 , 3523 , 3523 , 0 , 25.4612546125461 
05-May-2016 09:32,201603,WESTERN EUROPE-EU,GERMANY,MANCHESTER,MUNICH, 29589 , 29589 , 0 , 27054 , 27054 , 0 , 9.37014859170548 
05-May-2016 09:32,201603,WESTERN EUROPE-EU,GERMANY,MANCHESTER,STUTTGART, 8090 , 7893 , 197 , 0 , 0 , 0 , 0 
05-May-2016 09:32,201603,WESTERN EUROPE-EU,GERMANY,NEWCASTLE,DUSSELDORF, 3443 , 3443 , 0 , 2970 , 2970 , 0 , 15.9259259259259 
05-May-2016 09:32,201603,WESTERN EUROPE-EU,GERMANY,SOUTHAMPTON,DUSSELDORF, 2287 , 2287 , 0 , 0 , 0 , 0 , 0 
05-May-2016 09:32,201603,WESTERN EUROPE-EU,GERMANY,SOUTHAMPTON,HAMBURG, 595 , 595 , 0 , 0 , 0 , 0 , 0 
05-May-2016 09:32,201603,WESTERN EUROPE-EU,GERMANY,SOUTHEND,BERLIN (SCHONEFELD), 0 , 0 , 0 , 5075 , 5075 , 0 , 0 
05-May-2016 09:32,201603,WESTERN EUROPE-EU,GERMANY,SOUTHEND,MUNSTER-OSNABRUCK, 0 , 0 , 0 , 1127 , 1127 , 0 , 0 
05-May-2016 09:32,201603,WESTERN EUROPE-EU,GERMANY,STANSTED,BERLIN (SCHONEFELD), 39782 , 39782 , 0 , 20358 , 20358 , 0 , 95.4121229983299 
05-May-2016 09:32,201603,WESTERN EUROPE-EU,GERMANY,STANSTED,BERLIN (TEGEL), 107 , 0 , 107 , 94 , 0 , 94 , 13.8297872340426 
05-May-2016 09:32,201603,WESTERN EUROPE-EU,GERMANY,STANSTED,BREMEN, 16533 , 16533 , 0 , 17094 , 17094 , 0 ,-3.28185328185328 
05-May-2016 09:32,201603,WESTERN EUROPE-EU,GERMANY,STANSTED,COLOGNE BONN, 39536 , 38864 , 672 , 29304 , 29304 , 0 , 34.9167349167349 
05-May-2016 09:32,201603,WESTERN EUROPE-EU,GERMANY,STANSTED,DORTMUND, 10206 , 10206 , 0 , 9135 , 9135 , 0 , 11.7241379310345 
05-May-2016 09:32,201603,WESTERN EUROPE-EU,GERMANY,STANSTED,DUSSELDORF, 0 , 0 , 0 , 6217 , 6217 , 0 , 0 
05-May-2016 09:32,201603,WESTERN EUROPE-EU,GERMANY,STANSTED,HAHN, 21999 , 21999 , 0 , 20250 , 20250 , 0 , 8.63703703703704 
05-May-2016 09:32,201603,WESTERN EUROPE-EU,GERMANY,STANSTED,HAMBURG, 241 , 241 , 0 , 0 , 0 , 0 , 0 
05-May-2016 09:32,201603,WESTERN EUROPE-EU,GERMANY,STANSTED,HANOVER, 5379 , 5379 , 0 , 9295 , 9295 , 0 ,-42.1301775147929 
05-May-2016 09:32,201603,WESTERN EUROPE-EU,GERMANY,STANSTED,KARLSRUHE/BADEN BADEN, 9215 , 9215 , 0 , 8711 , 8711 , 0 , 5.78578808403168 
05-May-2016 09:32,201603,WESTERN EUROPE-EU,GERMANY,STANSTED,LEIPZIG, 4207 , 4207 , 0 , 5206 , 5206 , 0 ,-19.1893968497887 
05-May-2016 09:32,201603,WESTERN EUROPE-EU,GERMANY,STANSTED,MEMMINGEN ALLGAU, 9273 , 9273 , 0 , 8936 , 8936 , 0 , 3.77126230975828 
05-May-2016 09:32,201603,WESTERN EUROPE-EU,GERMANY,STANSTED,MUNICH, 8940 , 8940 , 0 , 8934 , 8934 , 0 , 6.71591672263264E-02 
05-May-2016 09:32,201603,WESTERN EUROPE-EU,GERMANY,STANSTED,NIEDERRHEIN, 6985 , 6985 , 0 , 7666 , 7666 , 0 ,-8.88338116357944 
05-May-2016 09:32,201603,WESTERN EUROPE-EU,GERMANY,STANSTED,NUREMBERG, 10720 , 10720 , 0 , 10506 , 10506 , 0 , 2.03693127736531 
05-May-2016 09:32,201603,WESTERN EUROPE-EU,GERMANY,STANSTED,STUTTGART, 6148 , 6148 , 0 , 5635 , 5635 , 0 , 9.10381543921917 
05-May-2016 09:32,201603,WEST AFRICA,GHANA,GATWICK,ACCRA, 140 , 0 , 140 , 140 , 0 , 140 , 0 
05-May-2016 09:32,201603,WEST AFRICA,GHANA,HEATHROW,ACCRA, 18503 , 18503 , 0 , 17535 , 17535 , 0 , 5.5203877958369 
05-May-2016 09:32,201603,WESTERN EUROPE-EU,GIBRALTAR,BIRMINGHAM,GIBRALTAR, 3386 , 3386 , 0 , 2516 , 2516 , 0 , 34.5786963434022 
05-May-2016 09:32,201603,WESTERN EUROPE-EU,GIBRALTAR,BRISTOL,GIBRALTAR, 3946 , 3946 , 0 , 0 , 0 , 0 , 0 
05-May-2016 09:32,201603,WESTERN EUROPE-EU,GIBRALTAR,GATWICK,GIBRALTAR, 12343 , 12343 , 0 , 9383 , 9383 , 0 , 31.546413726953 
05-May-2016 09:32,201603,WESTERN EUROPE-EU,GIBRALTAR,HEATHROW,GIBRALTAR, 9942 , 9942 , 0 , 9667 , 9667 , 0 , 2.84472949208648 
05-May-2016 09:32,201603,WESTERN EUROPE-EU,GIBRALTAR,LUTON,GIBRALTAR, 4330 , 4330 , 0 , 4689 , 4689 , 0 ,-7.65621667732992 
05-May-2016 09:32,201603,WESTERN EUROPE-EU,GIBRALTAR,MANCHESTER,GIBRALTAR, 4572 , 4572 , 0 , 4744 , 4744 , 0 ,-3.6256323777403 
05-May-2016 09:32,201603,WESTERN EUROPE-EU,GREECE,BIRMINGHAM,ATHENS, 0 , 0 , 0 , 359 , 208 , 151 , 0 
05-May-2016 09:32,201603,WESTERN EUROPE-EU,GREECE,BIRMINGHAM,RHODES, 217 , 0 , 217 , 220 , 0 , 220 ,-1.36363636363636 
05-May-2016 09:32,201603,WESTERN EUROPE-EU,GREECE,BRISTOL,CHANIA, 438 , 438 , 0 , 210 , 210 , 0 , 108.571428571429 
05-May-2016 09:32,201603,WESTERN EUROPE-EU,GREECE,BRISTOL,HERAKLION, 597 , 0 , 597 , 0 , 0 , 0 , 0 
05-May-2016 09:32,201603,WESTERN EUROPE-EU,GREECE,DONCASTER SHEFFIELD,ANDRAVIDA, 0 , 0 , 0 , 45 , 0 , 45 , 0 
05-May-2016 09:32,201603,WESTERN EUROPE-EU,GREECE,EAST MIDLANDS INTERNATIONAL,CHANIA, 0 , 0 , 0 , 209 , 209 , 0 , 0 
05-May-2016 09:32,201603,WESTERN EUROPE-EU,GREECE,EAST MIDLANDS INTERNATIONAL,CORFU, 0 , 0 , 0 , 202 , 202 , 0 , 0 
05-May-2016 09:32,201603,WESTERN EUROPE-EU,GREECE,EAST MIDLANDS INTERNATIONAL,RHODES, 0 , 0 , 0 , 198 , 198 , 0 , 0 
05-May-2016 09:32,201603,WESTERN EUROPE-EU,GREECE,EDINBURGH,ATHENS, 3066 , 3066 , 0 , 3102 , 3102 , 0 ,-1.1605415860735 
05-May-2016 09:32,201603,WESTERN EUROPE-EU,GREECE,EDINBURGH,HERAKLION, 213 , 213 , 0 , 218 , 218 , 0 ,-2.29357798165138 
05-May-2016 09:32,201603,WESTERN EUROPE-EU,GREECE,GATWICK,ATHENS, 14879 , 14879 , 0 , 13570 , 13570 , 0 , 9.64627855563744 
05-May-2016 09:32,201603,WESTERN EUROPE-EU,GREECE,GATWICK,CHANIA, 671 , 671 , 0 , 442 , 442 , 0 , 51.8099547511312 
05-May-2016 09:32,201603,WESTERN EUROPE-EU,GREECE,GATWICK,CORFU, 1590 , 1590 , 0 , 689 , 689 , 0 , 130.769230769231 
05-May-2016 09:32,201603,WESTERN EUROPE-EU,GREECE,GATWICK,HERAKLION, 2479 , 1495 , 984 , 882 , 652 , 230 , 181.065759637188 
05-May-2016 09:32,201603,WESTERN EUROPE-EU,GREECE,GATWICK,KALAMATA, 254 , 254 , 0 , 211 , 211 , 0 , 20.3791469194313 
05-May-2016 09:32,201603,WESTERN EUROPE-EU,GREECE,GATWICK,KEFALLINIA, 212 , 212 , 0 , 241 , 241 , 0 ,-12.0331950207469 
05-May-2016 09:32,201603,WESTERN EUROPE-EU,GREECE,GATWICK,KOS, 0 , 0 , 0 , 184 , 184 , 0 , 0 
05-May-2016 09:32,201603,WESTERN EUROPE-EU,GREECE,GATWICK,RHODES, 1797 , 1110 , 687 , 191 , 0 , 191 , 840.837696335078 
05-May-2016 09:32,201603,WESTERN EUROPE-EU,GREECE,GATWICK,SALONIKA, 7177 , 7177 , 0 , 6424 , 6424 , 0 , 11.7216687422167 
05-May-2016 09:32,201603,WESTERN EUROPE-EU,GREECE,GATWICK,THIRA (SANTORINI), 925 , 925 , 0 , 276 , 276 , 0 , 235.144927536232 
05-May-2016 09:32,201603,WESTERN EUROPE-EU,GREECE,GATWICK,ZAKINTHOS, 501 , 501 , 0 , 230 , 230 , 0 , 117.826086956522 
05-May-2016 09:32,201603,WESTERN EUROPE-EU,GREECE,GLASGOW,KOS, 0 , 0 , 0 , 176 , 176 , 0 , 0 
05-May-2016 09:32,201603,WESTERN EUROPE-EU,GREECE,HEATHROW,ATHENS, 50463 , 50463 , 0 , 47795 , 47795 , 0 , 5.58217386755937 
05-May-2016 09:32,201603,WESTERN EUROPE-EU,GREECE,LEEDS BRADFORD,CHANIA, 0 , 0 , 0 , 210 , 210 , 0 , 0 
05-May-2016 09:32,201603,WESTERN EUROPE-EU,GREECE,LUTON,CORFU, 210 , 210 , 0 , 661 , 661 , 0 ,-68.2299546142209 
05-May-2016 09:32,201603,WESTERN EUROPE-EU,GREECE,LUTON,HERAKLION, 189 , 184 , 5 , 364 , 364 , 0 ,-48.0769230769231 
05-May-2016 09:32,201603,WESTERN EUROPE-EU,GREECE,MANCHESTER,ATHENS, 6140 , 6140 , 0 , 6166 , 6166 , 0 ,-0.42166720726565 
05-May-2016 09:32,201603,WESTERN EUROPE-EU,GREECE,MANCHESTER,CHANIA, 1048 , 1048 , 0 , 387 , 387 , 0 , 170.801033591731 
05-May-2016 09:32,201603,WESTERN EUROPE-EU,GREECE,MANCHESTER,CORFU, 231 , 231 , 0 , 410 , 410 , 0 ,-43.6585365853659 
05-May-2016 09:32,201603,WESTERN EUROPE-EU,GREECE,MANCHESTER,HERAKLION, 1292 , 269 , 1023 , 612 , 212 , 400 , 111.111111111111 
05-May-2016 09:32,201603,WESTERN EUROPE-EU,GREECE,MANCHESTER,RHODES, 382 , 0 , 382 , 221 , 0 , 221 , 72.8506787330317 
05-May-2016 09:32,201603,WESTERN EUROPE-EU,GREECE,MANCHESTER,SALONIKA, 2667 , 2667 , 0 , 2331 , 2331 , 0 , 14.4144144144144 
05-May-2016 09:32,201603,WESTERN EUROPE-EU,GREECE,STANSTED,ATHENS, 20693 , 20693 , 0 , 19450 , 19450 , 0 , 6.39074550128535 
05-May-2016 09:32,201603,WESTERN EUROPE-EU,GREECE,STANSTED,CHANIA, 1076 , 1076 , 0 , 198 , 198 , 0 , 443.434343434343 
05-May-2016 09:32,201603,WESTERN EUROPE-EU,GREECE,STANSTED,CORFU, 0 , 0 , 0 , 187 , 187 , 0 , 0 
05-May-2016 09:32,201603,WESTERN EUROPE-EU,GREECE,STANSTED,KOS, 0 , 0 , 0 , 188 , 188 , 0 , 0 
05-May-2016 09:32,201603,WESTERN EUROPE-EU,GREECE,STANSTED,RHODES, 1978 , 1978 , 0 , 202 , 202 , 0 , 879.207920792079 
05-May-2016 09:32,201603,WESTERN EUROPE-EU,GREECE,STANSTED,SALONIKA, 7816 , 7816 , 0 , 8526 , 8526 , 0 ,-8.32746891860192 
05-May-2016 09:32,201603,CARIBBEAN AREA,GRENADA,GATWICK,GRENADA, 8643 , 8643 , 0 , 8461 , 8461 , 0 , 2.151045975653 
05-May-2016 09:32,201603,FAR EAST,HONG KONG,HEATHROW,HONG KONG (CHEK LAP KOK), 131244 , 131244 , 0 , 134938 , 134938 , 0 ,-2.73755354310869 
05-May-2016 09:32,201603,FAR EAST,HONG KONG,MANCHESTER,HONG KONG (CHEK LAP KOK), 10858 , 10858 , 0 , 10808 , 10808 , 0 , 0.462620281273131 
05-May-2016 09:32,201603,EASTERN EUROPE-EU,HUNGARY,BIRMINGHAM,BUDAPEST, 3557 , 3557 , 0 , 0 , 0 , 0 , 0 
05-May-2016 09:32,201603,EASTERN EUROPE-EU,HUNGARY,BRISTOL,BUDAPEST, 5074 , 5074 , 0 , 4552 , 4552 , 0 , 11.4674868189807 
05-May-2016 09:32,201603,EASTERN EUROPE-EU,HUNGARY,EAST MIDLANDS INTERNATIONAL,BUDAPEST, 2312 , 2312 , 0 , 2479 , 2479 , 0 ,-6.73658733360226 
05-May-2016 09:32,201603,EASTERN EUROPE-EU,HUNGARY,EDINBURGH,BUDAPEST, 2654 , 2654 , 0 , 2496 , 2496 , 0 , 6.3301282051282 
05-May-2016 09:32,201603,EASTERN EUROPE-EU,HUNGARY,GATWICK,BUDAPEST, 18733 , 18733 , 0 , 16126 , 16126 , 0 , 16.1664392905866 
05-May-2016 09:32,201603,EASTERN EUROPE-EU,HUNGARY,GLASGOW,BUDAPEST, 3301 , 3301 , 0 , 0 , 0 , 0 , 0 
05-May-2016 09:32,201603,EASTERN EUROPE-EU,HUNGARY,HEATHROW,BUDAPEST, 23816 , 23816 , 0 , 24713 , 24713 , 0 ,-3.62966859547607 
05-May-2016 09:32,201603,EASTERN EUROPE-EU,HUNGARY,LEEDS BRADFORD,BUDAPEST, 2273 , 2273 , 0 , 2524 , 2524 , 0 ,-9.9445324881141 
05-May-2016 09:32,201603,EASTERN EUROPE-EU,HUNGARY,LIVERPOOL (JOHN LENNON),BUDAPEST, 931 , 931 , 0 , 0 , 0 , 0 , 0 
05-May-2016 09:32,201603,EASTERN EUROPE-EU,HUNGARY,LUTON,BUDAPEST, 48293 , 48293 , 0 , 34479 , 34479 , 0 , 40.0649670814119 
05-May-2016 09:32,201603,EASTERN EUROPE-EU,HUNGARY,LUTON,DEBRECEN, 11403 , 11403 , 0 , 7037 , 7037 , 0 , 62.0434844393918 
05-May-2016 09:32,201603,EASTERN EUROPE-EU,HUNGARY,MANCHESTER,BUDAPEST, 11812 , 11812 , 0 , 11835 , 11835 , 0 ,-0.194338825517533 
05-May-2016 09:32,201603,EASTERN EUROPE-EU,HUNGARY,STANSTED,BUDAPEST, 30686 , 30686 , 0 , 31428 , 31428 , 0 ,-2.36095201730941 
05-May-2016 09:32,201603,WESTERN EUROPE-OTHER,ICELAND,ABERDEEN,KEFLAVIK, 1029 , 1029 , 0 , 0 , 0 , 0 , 0 
05-May-2016 09:32,201603,WESTERN EUROPE-OTHER,ICELAND,BELFAST INTERNATIONAL,KEFLAVIK, 2143 , 2143 , 0 , 2149 , 2149 , 0 ,-0.27919962773383 
05-May-2016 09:32,201603,WESTERN EUROPE-OTHER,ICELAND,BIRMINGHAM,KEFLAVIK, 5061 , 5061 , 0 , 3899 , 3899 , 0 , 29.802513464991 
05-May-2016 09:32,201603,WESTERN EUROPE-OTHER,ICELAND,BRISTOL,KEFLAVIK, 2976 , 2976 , 0 , 4346 , 4346 , 0 ,-31.5232397606995 
05-May-2016 09:32,201603,WESTERN EUROPE-OTHER,ICELAND,EDINBURGH,KEFLAVIK, 5361 , 5361 , 0 , 3958 , 3958 , 0 , 35.4471955533098 
05-May-2016 09:32,201603,WESTERN EUROPE-OTHER,ICELAND,GATWICK,KEFLAVIK, 37614 , 37058 , 556 , 28761 , 28761 , 0 , 30.781266298112 
05-May-2016 09:32,201603,WESTERN EUROPE-OTHER,ICELAND,GLASGOW,KEFLAVIK, 5826 , 5826 , 0 , 5416 , 5416 , 0 , 7.57016248153619 
05-May-2016 09:32,201603,WESTERN EUROPE-OTHER,ICELAND,HEATHROW,KEFLAVIK, 23328 , 23328 , 0 , 19579 , 19579 , 0 , 19.148066806272 
05-May-2016 09:32,201603,WESTERN EUROPE-OTHER,ICELAND,HUMBERSIDE,KEFLAVIK, 322 , 0 , 322 , 0 , 0 , 0 , 0 
05-May-2016 09:32,201603,WESTERN EUROPE-OTHER,ICELAND,LUTON,KEFLAVIK, 13582 , 13582 , 0 , 11494 , 11494 , 0 , 18.1659996519923 
05-May-2016 09:32,201603,WESTERN EUROPE-OTHER,ICELAND,MANCHESTER,KEFLAVIK, 16826 , 16274 , 552 , 11254 , 11254 , 0 , 49.5112848764884 
05-May-2016 09:32,201603,WESTERN EUROPE-OTHER,ICELAND,STANSTED,KEFLAVIK, 2653 , 2653 , 0 , 0 , 0 , 0 , 0 
05-May-2016 09:32,201603,INDIAN SUB-CONTINENT,INDIA,BIRMINGHAM,DELHI, 13859 , 13859 , 0 , 13475 , 13475 , 0 , 2.84972170686456 
05-May-2016 09:32,201603,INDIAN SUB-CONTINENT,INDIA,GATWICK,GOA, 6526 , 2474 , 4052 , 7446 , 0 , 7446 ,-12.3556271823798 
05-May-2016 09:32,201603,INDIAN SUB-CONTINENT,INDIA,HEATHROW,AMRITSAR, 926 , 926 , 0 , 0 , 0 , 0 , 0 
05-May-2016 09:32,201603,INDIAN SUB-CONTINENT,INDIA,HEATHROW,BANGALORE (BENGALURU), 13153 , 13153 , 0 , 13537 , 13537 , 0 ,-2.83666986776982 
05-May-2016 09:32,201603,INDIAN SUB-CONTINENT,INDIA,HEATHROW,CHENNAI, 10240 , 10240 , 0 , 9663 , 9663 , 0 , 5.97123046672876 
05-May-2016 09:32,201603,INDIAN SUB-CONTINENT,INDIA,HEATHROW,DELHI, 102259 , 102259 , 0 , 98139 , 98139 , 0 , 4.19812714619061 
05-May-2016 09:32,201603,INDIAN SUB-CONTINENT,INDIA,HEATHROW,HYDERABAD ( RAJIV GHANDI ), 10547 , 10547 , 0 , 10698 , 10698 , 0 ,-1.41147878108058 
05-May-2016 09:32,201603,INDIAN SUB-CONTINENT,INDIA,HEATHROW,MUMBAI, 79284 , 79284 , 0 , 75158 , 75158 , 0 , 5.48976822161314 
05-May-2016 09:32,201603,INDIAN SUB-CONTINENT,INDIA,LUTON,JAIPUR, 56 , 0 , 56 , 0 , 0 , 0 , 0 
05-May-2016 09:32,201603,INDIAN SUB-CONTINENT,INDIA,MANCHESTER,GOA, 3745 , 3745 , 0 , 3922 , 0 , 3922 ,-4.51300356960734 
05-May-2016 09:32,201603,FAR EAST,INDONESIA,GATWICK,JAKARTA (SOEKARNO-HATTA INTNL), 2051 , 2051 , 0 , 3993 , 3993 , 0 ,-48.6351114450288 
05-May-2016 09:32,201603,FAR EAST,INDONESIA,HEATHROW,JAKARTA (SOEKARNO-HATTA INTNL), 61 , 61 , 0 , 0 , 0 , 0 , 0 
05-May-2016 09:32,201603,MIDDLE EAST,IRAN,HEATHROW,TEHRAN IMAM KHOMEINI, 5079 , 5079 , 0 , 4713 , 4713 , 0 , 7.76575429662635 
05-May-2016 09:32,201603,MIDDLE EAST,IRAQ,GATWICK,BAGHDAD (GECA), 686 , 686 , 0 , 1466 , 1466 , 0 ,-53.206002728513 
05-May-2016 09:32,201603,MIDDLE EAST,IRAQ,GATWICK,SULAYMANIYAH INT, 981 , 981 , 0 , 1563 , 1563 , 0 ,-37.236084452975 
05-May-2016 09:32,201603,MIDDLE EAST,IRAQ,MANCHESTER,SULAYMANIYAH INT, 0 , 0 , 0 , 525 , 525 , 0 , 0 
05-May-2016 09:32,201603,WESTERN EUROPE-EU,IRISH REPUBLIC,ABERDEEN,DUBLIN, 3452 , 3452 , 0 , 3369 , 3369 , 0 , 2.46363906203621 
05-May-2016 09:32,201603,WESTERN EUROPE-EU,IRISH REPUBLIC,BELFAST INTERNATIONAL,DUBLIN, 0 , 0 , 0 , 455 , 0 , 455 , 0 
05-May-2016 09:32,201603,WESTERN EUROPE-EU,IRISH REPUBLIC,BELFAST INTERNATIONAL,KERRY COUNTY, 2 , 0 , 2 , 0 , 0 , 0 , 0 
05-May-2016 09:32,201603,WESTERN EUROPE-EU,IRISH REPUBLIC,BIRMINGHAM,CORK, 6316 , 6316 , 0 , 6805 , 6805 , 0 ,-7.18589272593681 
05-May-2016 09:32,201603,WESTERN EUROPE-EU,IRISH REPUBLIC,BIRMINGHAM,DUBLIN, 87010 , 87010 , 0 , 70621 , 70621 , 0 , 23.2069780943345 
05-May-2016 09:32,201603,WESTERN EUROPE-EU,IRISH REPUBLIC,BIRMINGHAM,IRELAND WEST(KNOCK), 556 , 556 , 0 , 1873 , 1873 , 0 ,-70.3150026695141 
05-May-2016 09:32,201603,WESTERN EUROPE-EU,IRISH REPUBLIC,BIRMINGHAM,SHANNON, 2569 , 2569 , 0 , 0 , 0 , 0 , 0 
05-May-2016 09:32,201603,WESTERN EUROPE-EU,IRISH REPUBLIC,BIRMINGHAM,WATERFORD, 750 , 750 , 0 , 1262 , 1262 , 0 ,-40.5705229793978 
05-May-2016 09:32,201603,WESTERN EUROPE-EU,IRISH REPUBLIC,BOURNEMOUTH,DUBLIN, 648 , 648 , 0 , 0 , 0 , 0 , 0 
05-May-2016 09:32,201603,WESTERN EUROPE-EU,IRISH REPUBLIC,BRISTOL,CORK, 3117 , 3117 , 0 , 3525 , 3525 , 0 ,-11.5744680851064 
05-May-2016 09:32,201603,WESTERN EUROPE-EU,IRISH REPUBLIC,BRISTOL,DUBLIN, 33322 , 33322 , 0 , 30936 , 30936 , 0 , 7.71269718127748 
05-May-2016 09:32,201603,WESTERN EUROPE-EU,IRISH REPUBLIC,BRISTOL,IRELAND WEST(KNOCK), 0 , 0 , 0 , 419 , 419 , 0 , 0 
05-May-2016 09:32,201603,WESTERN EUROPE-EU,IRISH REPUBLIC,CARDIFF WALES,CORK, 1059 , 1059 , 0 , 0 , 0 , 0 , 0 
05-May-2016 09:32,201603,WESTERN EUROPE-EU,IRISH REPUBLIC,CARDIFF WALES,DUBLIN, 10438 , 10399 , 39 , 10063 , 6446 , 3617 , 3.72652290569413 
05-May-2016 09:32,201603,WESTERN EUROPE-EU,IRISH REPUBLIC,CARDIFF WALES,SHANNON, 0 , 0 , 0 , 592 , 0 , 592 , 0 
05-May-2016 09:32,201603,WESTERN EUROPE-EU,IRISH REPUBLIC,DONCASTER SHEFFIELD,DUBLIN, 1772 , 1772 , 0 , 0 , 0 , 0 , 0 
05-May-2016 09:32,201603,WESTERN EUROPE-EU,IRISH REPUBLIC,EAST MIDLANDS INTERNATIONAL,DUBLIN, 21666 , 21666 , 0 , 18505 , 18505 , 0 , 17.0818697649284 
05-May-2016 09:32,201603,WESTERN EUROPE-EU,IRISH REPUBLIC,EAST MIDLANDS INTERNATIONAL,IRELAND WEST(KNOCK), 5820 , 5820 , 0 , 5036 , 5036 , 0 , 15.5679110405083 
05-May-2016 09:32,201603,WESTERN EUROPE-EU,IRISH REPUBLIC,EDINBURGH,CORK, 3460 , 3460 , 0 , 3373 , 3373 , 0 , 2.57930625555885 
05-May-2016 09:32,201603,WESTERN EUROPE-EU,IRISH REPUBLIC,EDINBURGH,DUBLIN, 50488 , 50307 , 181 , 48674 , 47913 , 761 , 3.72683568229445 
05-May-2016 09:32,201603,WESTERN EUROPE-EU,IRISH REPUBLIC,EDINBURGH,IRELAND WEST(KNOCK), 352 , 352 , 0 , 0 , 0 , 0 , 0 
05-May-2016 09:32,201603,WESTERN EUROPE-EU,IRISH REPUBLIC,EDINBURGH,SHANNON, 1462 , 1462 , 0 , 668 , 668 , 0 , 118.862275449102 
05-May-2016 09:32,201603,WESTERN EUROPE-EU,IRISH REPUBLIC,EXETER,DUBLIN, 2404 , 2404 , 0 , 3722 , 3722 , 0 ,-35.4110693175712 
05-May-2016 09:32,201603,WESTERN EUROPE-EU,IRISH REPUBLIC,GATWICK,CORK, 10326 , 10326 , 0 , 10315 , 10315 , 0 , 0.106640814348037 
05-May-2016 09:32,201603,WESTERN EUROPE-EU,IRISH REPUBLIC,GATWICK,DUBLIN, 108456 , 108456 , 0 , 91339 , 91339 , 0 , 18.7400781703325 
05-May-2016 09:32,201603,WESTERN EUROPE-EU,IRISH REPUBLIC,GATWICK,IRELAND WEST(KNOCK), 6291 , 6291 , 0 , 5686 , 5686 , 0 , 10.6401688357369 
05-May-2016 09:32,201603,WESTERN EUROPE-EU,IRISH REPUBLIC,GATWICK,SHANNON, 9240 , 9240 , 0 , 9057 , 9057 , 0 , 2.02053660152368 
05-May-2016 09:32,201603,WESTERN EUROPE-EU,IRISH REPUBLIC,GLASGOW,CORK, 1870 , 1870 , 0 , 1982 , 1982 , 0 ,-5.65085771947528 
05-May-2016 09:32,201603,WESTERN EUROPE-EU,IRISH REPUBLIC,GLASGOW,DONEGAL, 751 , 751 , 0 , 430 , 430 , 0 , 74.6511627906977 
05-May-2016 09:32,201603,WESTERN EUROPE-EU,IRISH REPUBLIC,GLASGOW,DUBLIN, 43417 , 43311 , 106 , 37970 , 37970 , 0 , 14.3455359494338 
05-May-2016 09:32,201603,WESTERN EUROPE-EU,IRISH REPUBLIC,HEATHROW,CORK, 31508 , 31508 , 0 , 30147 , 30147 , 0 , 4.51454539423492 
05-May-2016 09:32,201603,WESTERN EUROPE-EU,IRISH REPUBLIC,HEATHROW,DUBLIN, 142575 , 142575 , 0 , 135593 , 135593 , 0 , 5.14923336750422 
05-May-2016 09:32,201603,WESTERN EUROPE-EU,IRISH REPUBLIC,HEATHROW,SHANNON, 21249 , 21249 , 0 , 18516 , 18516 , 0 , 14.7602073882048 
05-May-2016 09:32,201603,WESTERN EUROPE-EU,IRISH REPUBLIC,INVERNESS,DUBLIN, 1134 , 1134 , 0 , 2303 , 2303 , 0 ,-50.7598784194529 
05-May-2016 09:32,201603,WESTERN EUROPE-EU,IRISH REPUBLIC,ISLE OF MAN,DUBLIN, 3289 , 3190 , 99 , 2770 , 2770 , 0 , 18.7364620938628 
05-May-2016 09:32,201603,WESTERN EUROPE-EU,IRISH REPUBLIC,JERSEY,DUBLIN, 1031 , 1031 , 0 , 121 , 121 , 0 , 752.066115702479 
05-May-2016 09:32,201603,WESTERN EUROPE-EU,IRISH REPUBLIC,LEEDS BRADFORD,CORK, 493 , 493 , 0 , 0 , 0 , 0 , 0 
05-May-2016 09:32,201603,WESTERN EUROPE-EU,IRISH REPUBLIC,LEEDS BRADFORD,DUBLIN, 24673 , 24673 , 0 , 23894 , 23894 , 0 , 3.26023269440027 
05-May-2016 09:32,201603,WESTERN EUROPE-EU,IRISH REPUBLIC,LIVERPOOL (JOHN LENNON),CORK, 6965 , 6965 , 0 , 6620 , 6620 , 0 , 5.21148036253777 
05-May-2016 09:32,201603,WESTERN EUROPE-EU,IRISH REPUBLIC,LIVERPOOL (JOHN LENNON),DUBLIN, 48353 , 48353 , 0 , 27048 , 27048 , 0 , 78.7673765158237 
05-May-2016 09:32,201603,WESTERN EUROPE-EU,IRISH REPUBLIC,LIVERPOOL (JOHN LENNON),IRELAND WEST(KNOCK), 7270 , 7270 , 0 , 7691 , 7691 , 0 ,-5.47393056819659 
05-May-2016 09:32,201603,WESTERN EUROPE-EU,IRISH REPUBLIC,LONDON CITY,CORK, 6735 , 6735 , 0 , 0 , 0 , 0 , 0 
05-May-2016 09:32,201603,WESTERN EUROPE-EU,IRISH REPUBLIC,LONDON CITY,DUBLIN, 38968 , 38968 , 0 , 45167 , 45167 , 0 ,-13.7246219585095 
05-May-2016 09:32,201603,WESTERN EUROPE-EU,IRISH REPUBLIC,LUTON,DUBLIN, 29166 , 29166 , 0 , 28575 , 28439 , 136 , 2.06824146981627 
05-May-2016 09:32,201603,WESTERN EUROPE-EU,IRISH REPUBLIC,LUTON,IRELAND WEST(KNOCK), 9386 , 9386 , 0 , 8504 , 8504 , 0 , 10.3715898400753 
05-May-2016 09:32,201603,WESTERN EUROPE-EU,IRISH REPUBLIC,LUTON,KERRY COUNTY, 9050 , 9050 , 0 , 8538 , 8538 , 0 , 5.9967205434528 
05-May-2016 09:32,201603,WESTERN EUROPE-EU,IRISH REPUBLIC,LUTON,WATERFORD, 2454 , 2454 , 0 , 0 , 0 , 0 , 0 
05-May-2016 09:32,201603,WESTERN EUROPE-EU,IRISH REPUBLIC,MANCHESTER,CORK, 6640 , 6640 , 0 , 6885 , 6885 , 0 ,-3.55846042120552 
05-May-2016 09:32,201603,WESTERN EUROPE-EU,IRISH REPUBLIC,MANCHESTER,DUBLIN, 86165 , 86002 , 163 , 71742 , 71378 , 364 , 20.1039837194391 
05-May-2016 09:32,201603,WESTERN EUROPE-EU,IRISH REPUBLIC,MANCHESTER,IRELAND WEST(KNOCK), 2305 , 2305 , 0 , 2023 , 2023 , 0 , 13.9396935244686 
05-May-2016 09:32,201603,WESTERN EUROPE-EU,IRISH REPUBLIC,MANCHESTER,SHANNON, 9167 , 9167 , 0 , 8568 , 8568 , 0 , 6.99112978524743 
05-May-2016 09:32,201603,WESTERN EUROPE-EU,IRISH REPUBLIC,NEWCASTLE,CORK, 904 , 904 , 0 , 1627 , 1627 , 0 ,-44.4376152427781 
05-May-2016 09:32,201603,WESTERN EUROPE-EU,IRISH REPUBLIC,NEWCASTLE,DUBLIN, 18036 , 18036 , 0 , 17447 , 17447 , 0 , 3.37593855677194 
05-May-2016 09:32,201603,WESTERN EUROPE-EU,IRISH REPUBLIC,NEWQUAY,DUBLIN, 838 , 838 , 0 , 0 , 0 , 0 , 0 
05-May-2016 09:32,201603,WESTERN EUROPE-EU,IRISH REPUBLIC,SOUTHAMPTON,CORK, 871 , 871 , 0 , 0 , 0 , 0 , 0 
05-May-2016 09:32,201603,WESTERN EUROPE-EU,IRISH REPUBLIC,SOUTHAMPTON,DUBLIN, 12223 , 12223 , 0 , 12971 , 12971 , 0 ,-5.76671035386632 
05-May-2016 09:32,201603,WESTERN EUROPE-EU,IRISH REPUBLIC,SOUTHEND,DUBLIN, 95 , 95 , 0 , 1294 , 1294 , 0 ,-92.6584234930448 
05-May-2016 09:32,201603,WESTERN EUROPE-EU,IRISH REPUBLIC,STANSTED,CORK, 27825 , 27825 , 0 , 26077 , 26077 , 0 , 6.70322506423285 
05-May-2016 09:32,201603,WESTERN EUROPE-EU,IRISH REPUBLIC,STANSTED,DUBLIN, 77475 , 77475 , 0 , 73144 , 73144 , 0 , 5.921196543804 
05-May-2016 09:32,201603,WESTERN EUROPE-EU,IRISH REPUBLIC,STANSTED,IRELAND WEST(KNOCK), 13457 , 13457 , 0 , 12308 , 12308 , 0 , 9.33539161520962 
05-May-2016 09:32,201603,WESTERN EUROPE-EU,IRISH REPUBLIC,STANSTED,KERRY COUNTY, 6236 , 6236 , 0 , 5127 , 5127 , 0 , 21.630583187049 
05-May-2016 09:32,201603,WESTERN EUROPE-EU,IRISH REPUBLIC,STANSTED,SHANNON, 20345 , 20345 , 0 , 18699 , 18699 , 0 , 8.80260976522809 
05-May-2016 09:32,201603,WESTERN EUROPE-EU,IRISH REPUBLIC,SUMBURGH,DUBLIN, 0 , 0 , 0 , 636 , 0 , 636 , 0 
05-May-2016 09:32,201603,NEAR EAST,ISRAEL,CARDIFF WALES,TEL AVIV, 0 , 0 , 0 , 167 , 0 , 167 , 0 
05-May-2016 09:32,201603,NEAR EAST,ISRAEL,GATWICK,TEL AVIV, 4525 , 4525 , 0 , 4633 , 4633 , 0 ,-2.33110295704727 
05-May-2016 09:32,201603,NEAR EAST,ISRAEL,HEATHROW,TEL AVIV, 46994 , 46994 , 0 , 47792 , 47792 , 0 ,-1.66973552058922 
05-May-2016 09:32,201603,NEAR EAST,ISRAEL,LUTON,OVDA, 1015 , 1015 , 0 , 0 , 0 , 0 , 0 
05-May-2016 09:32,201603,NEAR EAST,ISRAEL,LUTON,TEL AVIV, 23112 , 23112 , 0 , 22191 , 22191 , 0 , 4.15033121535758 
05-May-2016 09:32,201603,NEAR EAST,ISRAEL,MANCHESTER,TEL AVIV, 2777 , 2777 , 0 , 3024 , 3024 , 0 ,-8.16798941798942 
05-May-2016 09:32,201603,WESTERN EUROPE-EU,ITALY,BELFAST CITY (GEORGE BEST),VERONA VILLAFRANCA, 1091 , 272 , 819 , 1074 , 0 , 1074 , 1.5828677839851 
05-May-2016 09:32,201603,WESTERN EUROPE-EU,ITALY,BIRMINGHAM,FLORENCE, 0 , 0 , 0 , 2456 , 2456 , 0 , 0 
05-May-2016 09:32,201603,WESTERN EUROPE-EU,ITALY,BIRMINGHAM,MILAN (MALPENSA), 8510 , 8510 , 0 , 4343 , 4343 , 0 , 95.9475017269169 
05-May-2016 09:32,201603,WESTERN EUROPE-EU,ITALY,BIRMINGHAM,NAPLES, 189 , 0 , 189 , 0 , 0 , 0 , 0 
05-May-2016 09:32,201603,WESTERN EUROPE-EU,ITALY,BIRMINGHAM,ROME (FIUMICINO), 4388 , 4388 , 0 , 3197 , 3197 , 0 , 37.2536753206131 
05-May-2016 09:32,201603,WESTERN EUROPE-EU,ITALY,BIRMINGHAM,TURIN, 3068 , 1163 , 1905 , 3702 , 1105 , 2597 ,-17.1258779038358 
05-May-2016 09:32,201603,WESTERN EUROPE-EU,ITALY,BIRMINGHAM,VENICE, 2308 , 2308 , 0 , 421 , 421 , 0 , 448.218527315914 
05-May-2016 09:32,201603,WESTERN EUROPE-EU,ITALY,BIRMINGHAM,VERONA VILLAFRANCA, 1440 , 0 , 1440 , 0 , 0 , 0 , 0 
05-May-2016 09:32,201603,WESTERN EUROPE-EU,ITALY,BOURNEMOUTH,TURIN, 0 , 0 , 0 , 496 , 0 , 496 , 0 
05-May-2016 09:32,201603,WESTERN EUROPE-EU,ITALY,BRISTOL,BERGAMO, 2403 , 2403 , 0 , 325 , 325 , 0 , 639.384615384615 
05-May-2016 09:32,201603,WESTERN EUROPE-EU,ITALY,BRISTOL,BOLOGNA, 0 , 0 , 0 , 277 , 277 , 0 , 0 
05-May-2016 09:32,201603,WESTERN EUROPE-EU,ITALY,BRISTOL,MILAN (MALPENSA), 317 , 317 , 0 , 611 , 611 , 0 ,-48.1178396072013 
05-May-2016 09:32,201603,WESTERN EUROPE-EU,ITALY,BRISTOL,NAPLES, 221 , 0 , 221 , 0 , 0 , 0 , 0 
05-May-2016 09:32,201603,WESTERN EUROPE-EU,ITALY,BRISTOL,PISA, 205 , 205 , 0 , 2253 , 2253 , 0 ,-90.9010208610741 
05-May-2016 09:32,201603,WESTERN EUROPE-EU,ITALY,BRISTOL,ROME (FIUMICINO), 9252 , 9252 , 0 , 9568 , 9568 , 0 ,-3.30267558528428 
05-May-2016 09:32,201603,WESTERN EUROPE-EU,ITALY,BRISTOL,TREVISO, 2120 , 2120 , 0 , 318 , 318 , 0 , 566.666666666667 
05-May-2016 09:32,201603,WESTERN EUROPE-EU,ITALY,BRISTOL,TURIN, 1714 , 0 , 1714 , 633 , 0 , 633 , 170.774091627172 
05-May-2016 09:32,201603,WESTERN EUROPE-EU,ITALY,BRISTOL,VENICE, 1334 , 1334 , 0 , 0 , 0 , 0 , 0 
05-May-2016 09:32,201603,WESTERN EUROPE-EU,ITALY,BRISTOL,VERONA VILLAFRANCA, 681 , 0 , 681 , 286 , 0 , 286 , 138.111888111888 
05-May-2016 09:32,201603,WESTERN EUROPE-EU,ITALY,CARDIFF WALES,MILAN (MALPENSA), 1902 , 1902 , 0 , 0 , 0 , 0 , 0 
05-May-2016 09:32,201603,WESTERN EUROPE-EU,ITALY,CARDIFF WALES,PARMA, 0 , 0 , 0 , 38 , 0 , 38 , 0 
05-May-2016 09:32,201603,WESTERN EUROPE-EU,ITALY,CARDIFF WALES,ROME (FIUMICINO), 0 , 0 , 0 , 3196 , 0 , 3196 , 0 
05-May-2016 09:32,201603,WESTERN EUROPE-EU,ITALY,DONCASTER SHEFFIELD,TURIN, 145 , 0 , 145 , 164 , 0 , 164 ,-11.5853658536585 
05-May-2016 09:32,201603,WESTERN EUROPE-EU,ITALY,EAST MIDLANDS INTERNATIONAL,BERGAMO, 4710 , 4710 , 0 , 4253 , 4253 , 0 , 10.7453562191394 
05-May-2016 09:32,201603,WESTERN EUROPE-EU,ITALY,EAST MIDLANDS INTERNATIONAL,NAPLES, 184 , 0 , 184 , 0 , 0 , 0 , 0 
05-May-2016 09:32,201603,WESTERN EUROPE-EU,ITALY,EAST MIDLANDS INTERNATIONAL,PISA, 0 , 0 , 0 , 322 , 322 , 0 , 0 
05-May-2016 09:32,201603,WESTERN EUROPE-EU,ITALY,EAST MIDLANDS INTERNATIONAL,ROME (CIAMPINO), 1635 , 1635 , 0 , 547 , 547 , 0 , 198.90310786106 
05-May-2016 09:32,201603,WESTERN EUROPE-EU,ITALY,EAST MIDLANDS INTERNATIONAL,TREVISO, 4668 , 4668 , 0 , 3254 , 3254 , 0 , 43.4542102028273 
05-May-2016 09:32,201603,WESTERN EUROPE-EU,ITALY,EDINBURGH,BOLOGNA, 1370 , 1370 , 0 , 300 , 300 , 0 , 356.666666666667 
05-May-2016 09:32,201603,WESTERN EUROPE-EU,ITALY,EDINBURGH,MILAN (MALPENSA), 13323 , 13323 , 0 , 8963 , 8963 , 0 , 48.6444270891443 
05-May-2016 09:32,201603,WESTERN EUROPE-EU,ITALY,EDINBURGH,NAPLES, 542 , 542 , 0 , 256 , 256 , 0 , 111.71875 
05-May-2016 09:32,201603,WESTERN EUROPE-EU,ITALY,EDINBURGH,PISA, 1569 , 1569 , 0 , 300 , 300 , 0 , 423 
05-May-2016 09:32,201603,WESTERN EUROPE-EU,ITALY,EDINBURGH,ROME (CIAMPINO), 5400 , 5400 , 0 , 5343 , 5343 , 0 , 1.06681639528355 
05-May-2016 09:32,201603,WESTERN EUROPE-EU,ITALY,EDINBURGH,ROME (FIUMICINO), 578 , 578 , 0 , 0 , 0 , 0 , 0 
05-May-2016 09:32,201603,WESTERN EUROPE-EU,ITALY,EDINBURGH,VENICE, 5164 , 5164 , 0 , 0 , 0 , 0 , 0 
05-May-2016 09:32,201603,WESTERN EUROPE-EU,ITALY,EDINBURGH,VERONA VILLAFRANCA, 1048 , 1048 , 0 , 1141 , 1141 , 0 ,-8.15074496056091 
05-May-2016 09:32,201603,WESTERN EUROPE-EU,ITALY,GATWICK,BARI (PALESE), 1317 , 1317 , 0 , 3025 , 3025 , 0 ,-56.4628099173554 
05-May-2016 09:32,201603,WESTERN EUROPE-EU,ITALY,GATWICK,BOLOGNA, 7563 , 7563 , 0 , 9021 , 9021 , 0 ,-16.1622879946791 
05-May-2016 09:32,201603,WESTERN EUROPE-EU,ITALY,GATWICK,CATANIA (FONTANAROSSA), 6475 , 6475 , 0 , 5099 , 5099 , 0 , 26.9856834673465 
05-May-2016 09:32,201603,WESTERN EUROPE-EU,ITALY,GATWICK,FLORENCE, 7591 , 7591 , 0 , 6994 , 6994 , 0 , 8.53588790391764 
05-May-2016 09:32,201603,WESTERN EUROPE-EU,ITALY,GATWICK,GENOA, 4470 , 4470 , 0 , 4925 , 4925 , 0 ,-9.23857868020304 
05-May-2016 09:32,201603,WESTERN EUROPE-EU,ITALY,GATWICK,MILAN (LINATE), 25453 , 25453 , 0 , 9442 , 9442 , 0 , 169.572124549884 
05-May-2016 09:32,201603,WESTERN EUROPE-EU,ITALY,GATWICK,MILAN (MALPENSA), 43757 , 43757 , 0 , 41620 , 41620 , 0 , 5.13455069678039 
05-May-2016 09:32,201603,WESTERN EUROPE-EU,ITALY,GATWICK,NAPLES, 24024 , 23498 , 526 , 24387 , 23912 , 475 ,-1.48849797023004 
05-May-2016 09:32,201603,WESTERN EUROPE-EU,ITALY,GATWICK,OLBIA, 306 , 306 , 0 , 260 , 260 , 0 , 17.6923076923077 
05-May-2016 09:32,201603,WESTERN EUROPE-EU,ITALY,GATWICK,PALERMO, 2950 , 2950 , 0 , 3041 , 3041 , 0 ,-2.99243669845446 
05-May-2016 09:32,201603,WESTERN EUROPE-EU,ITALY,GATWICK,PISA, 14477 , 14477 , 0 , 13716 , 13716 , 0 , 5.5482648002333 
05-May-2016 09:32,201603,WESTERN EUROPE-EU,ITALY,GATWICK,ROME (FIUMICINO), 59417 , 59417 , 0 , 56284 , 56284 , 0 , 5.56641319024945 
05-May-2016 09:32,201603,WESTERN EUROPE-EU,ITALY,GATWICK,TURIN, 24614 , 19527 , 5087 , 26653 , 18166 , 8487 ,-7.65017071249015 
05-May-2016 09:32,201603,WESTERN EUROPE-EU,ITALY,GATWICK,VENICE, 57831 , 57831 , 0 , 43507 , 43507 , 0 , 32.9234376077413 
05-May-2016 09:32,201603,WESTERN EUROPE-EU,ITALY,GATWICK,VERONA VILLAFRANCA, 16645 , 14850 , 1795 , 16999 , 15240 , 1759 ,-2.08247543973175 
05-May-2016 09:32,201603,WESTERN EUROPE-EU,ITALY,GLASGOW,MILAN (MALPENSA), 2190 , 2190 , 0 , 0 , 0 , 0 , 0 
05-May-2016 09:32,201603,WESTERN EUROPE-EU,ITALY,GLASGOW,ROME (FIUMICINO), 821 , 821 , 0 , 0 , 0 , 0 , 0 
05-May-2016 09:32,201603,WESTERN EUROPE-EU,ITALY,GLASGOW,TURIN, 1804 , 0 , 1804 , 2081 , 0 , 2081 ,-13.3109082172033 
05-May-2016 09:32,201603,WESTERN EUROPE-EU,ITALY,HEATHROW,BOLOGNA, 19660 , 19660 , 0 , 20727 , 20727 , 0 ,-5.14787475273797 
05-May-2016 09:32,201603,WESTERN EUROPE-EU,ITALY,HEATHROW,MILAN (LINATE), 48818 , 48818 , 0 , 54162 , 54162 , 0 ,-9.86669620767328 
05-May-2016 09:32,201603,WESTERN EUROPE-EU,ITALY,HEATHROW,MILAN (MALPENSA), 16802 , 16802 , 0 , 12076 , 12076 , 0 , 39.1354753229546 
05-May-2016 09:32,201603,WESTERN EUROPE-EU,ITALY,HEATHROW,PISA, 7218 , 7218 , 0 , 7325 , 7325 , 0 ,-1.46075085324232 
05-May-2016 09:32,201603,WESTERN EUROPE-EU,ITALY,HEATHROW,ROME (FIUMICINO), 72309 , 72309 , 0 , 72119 , 72119 , 0 , 0.263453458866595 
05-May-2016 09:32,201603,WESTERN EUROPE-EU,ITALY,HEATHROW,VENICE, 8313 , 8313 , 0 , 7965 , 7965 , 0 , 4.36911487758945 
05-May-2016 09:32,201603,WESTERN EUROPE-EU,ITALY,LEEDS BRADFORD,NAPLES, 438 , 438 , 0 , 287 , 287 , 0 , 52.6132404181185 
05-May-2016 09:32,201603,WESTERN EUROPE-EU,ITALY,LEEDS BRADFORD,PISA, 271 , 271 , 0 , 0 , 0 , 0 , 0 
05-May-2016 09:32,201603,WESTERN EUROPE-EU,ITALY,LEEDS BRADFORD,ROME (FIUMICINO), 2453 , 2453 , 0 , 2646 , 2646 , 0 ,-7.29402872260015 
05-May-2016 09:32,201603,WESTERN EUROPE-EU,ITALY,LEEDS BRADFORD,TREVISO, 1247 , 1247 , 0 , 303 , 303 , 0 , 311.551155115512 
05-May-2016 09:32,201603,WESTERN EUROPE-EU,ITALY,LEEDS BRADFORD,VENICE, 441 , 441 , 0 , 0 , 0 , 0 , 0 
05-May-2016 09:32,201603,WESTERN EUROPE-EU,ITALY,LIVERPOOL (JOHN LENNON),NAPLES, 456 , 456 , 0 , 529 , 529 , 0 ,-13.7996219281664 
05-May-2016 09:32,201603,WESTERN EUROPE-EU,ITALY,LIVERPOOL (JOHN LENNON),PISA, 1234 , 1234 , 0 , 244 , 244 , 0 , 405.737704918033 
05-May-2016 09:32,201603,WESTERN EUROPE-EU,ITALY,LONDON CITY,FLORENCE, 7433 , 7433 , 0 , 7952 , 7952 , 0 ,-6.52665995975855 
05-May-2016 09:32,201603,WESTERN EUROPE-EU,ITALY,LONDON CITY,MILAN (LINATE), 12891 , 12891 , 0 , 14300 , 14300 , 0 ,-9.85314685314685 
05-May-2016 09:32,201603,WESTERN EUROPE-EU,ITALY,LONDON CITY,ROME (FIUMICINO), 4162 , 4162 , 0 , 3836 , 3836 , 0 , 8.49843587069864 
05-May-2016 09:32,201603,WESTERN EUROPE-EU,ITALY,LONDON CITY,VENICE, 317 , 317 , 0 , 138 , 138 , 0 , 129.710144927536 
05-May-2016 09:32,201603,WESTERN EUROPE-EU,ITALY,LUTON,BOLOGNA, 1 , 0 , 1 , 0 , 0 , 0 , 0 
05-May-2016 09:32,201603,WESTERN EUROPE-EU,ITALY,LUTON,CATANIA (FONTANAROSSA), 2648 , 2648 , 0 , 3475 , 3475 , 0 ,-23.7985611510791 
05-May-2016 09:32,201603,WESTERN EUROPE-EU,ITALY,LUTON,MILAN (LINATE), 1 , 0 , 1 , 0 , 0 , 0 , 0 
05-May-2016 09:32,201603,WESTERN EUROPE-EU,ITALY,LUTON,MILAN (MALPENSA), 9312 , 9312 , 0 , 10340 , 10340 , 0 ,-9.94197292069632 
05-May-2016 09:32,201603,WESTERN EUROPE-EU,ITALY,LUTON,NAPLES, 4715 , 4715 , 0 , 4526 , 4526 , 0 , 4.17587273530711 
05-May-2016 09:32,201603,WESTERN EUROPE-EU,ITALY,LUTON,PISA, 634 , 634 , 0 , 304 , 304 , 0 , 108.552631578947 
05-May-2016 09:32,201603,WESTERN EUROPE-EU,ITALY,LUTON,ROME (FIUMICINO), 8739 , 8739 , 0 , 7584 , 7584 , 0 , 15.2294303797468 
05-May-2016 09:32,201603,WESTERN EUROPE-EU,ITALY,LUTON,TURIN, 788 , 788 , 0 , 164 , 0 , 164 , 380.487804878049 
05-May-2016 09:32,201603,WESTERN EUROPE-EU,ITALY,LUTON,VENICE, 6234 , 6234 , 0 , 5316 , 5316 , 0 , 17.2686230248307 
05-May-2016 09:32,201603,WESTERN EUROPE-EU,ITALY,MANCHESTER,BERGAMO, 11663 , 11663 , 0 , 11178 , 11178 , 0 , 4.33887994274468 
05-May-2016 09:32,201603,WESTERN EUROPE-EU,ITALY,MANCHESTER,BOLOGNA, 2462 , 2462 , 0 , 324 , 324 , 0 , 659.876543209877 
05-May-2016 09:32,201603,WESTERN EUROPE-EU,ITALY,MANCHESTER,CATANIA (FONTANAROSSA), 3061 , 3061 , 0 , 2478 , 2478 , 0 , 23.5270379338176 
05-May-2016 09:32,201603,WESTERN EUROPE-EU,ITALY,MANCHESTER,MILAN (MALPENSA), 5279 , 5123 , 156 , 5240 , 5240 , 0 , 0.744274809160305 
05-May-2016 09:32,201603,WESTERN EUROPE-EU,ITALY,MANCHESTER,NAPLES, 937 , 540 , 397 , 609 , 219 , 390 , 53.8587848932677 
05-May-2016 09:32,201603,WESTERN EUROPE-EU,ITALY,MANCHESTER,PISA, 3726 , 3726 , 0 , 0 , 0 , 0 , 0 
05-May-2016 09:32,201603,WESTERN EUROPE-EU,ITALY,MANCHESTER,ROME (CIAMPINO), 12074 , 12074 , 0 , 9552 , 9552 , 0 , 26.4028475711893 
05-May-2016 09:32,201603,WESTERN EUROPE-EU,ITALY,MANCHESTER,ROME (FIUMICINO), 5733 , 5733 , 0 , 6598 , 6524 , 74 ,-13.1100333434374 
05-May-2016 09:32,201603,WESTERN EUROPE-EU,ITALY,MANCHESTER,TURIN, 5800 , 2727 , 3073 , 7092 , 994 , 6098 ,-18.2177100958827 
05-May-2016 09:32,201603,WESTERN EUROPE-EU,ITALY,MANCHESTER,VENICE, 9292 , 9292 , 0 , 7149 , 7149 , 0 , 29.9762204504126 
05-May-2016 09:32,201603,WESTERN EUROPE-EU,ITALY,MANCHESTER,VERONA VILLAFRANCA, 2632 , 1064 , 1568 , 2446 , 1047 , 1399 , 7.60425183973835 
05-May-2016 09:32,201603,WESTERN EUROPE-EU,ITALY,NEWCASTLE,ROME (FIUMICINO), 730 , 730 , 0 , 0 , 0 , 0 , 0 
05-May-2016 09:32,201603,WESTERN EUROPE-EU,ITALY,NEWCASTLE,TURIN, 153 , 0 , 153 , 534 , 0 , 534 ,-71.3483146067416 
05-May-2016 09:32,201603,WESTERN EUROPE-EU,ITALY,PRESTWICK,PISA, 584 , 584 , 0 , 0 , 0 , 0 , 0 
05-May-2016 09:32,201603,WESTERN EUROPE-EU,ITALY,PRESTWICK,ROME (CIAMPINO), 1312 , 1312 , 0 , 286 , 286 , 0 , 358.741258741259 
05-May-2016 09:32,201603,WESTERN EUROPE-EU,ITALY,SOUTHAMPTON,TRIESTE (RONCHI DEI LEGIONARI), 0 , 0 , 0 , 149 , 0 , 149 , 0 
05-May-2016 09:32,201603,WESTERN EUROPE-EU,ITALY,SOUTHEND,VENICE, 4721 , 4721 , 0 , 4637 , 4637 , 0 , 1.81151606642226 
05-May-2016 09:32,201603,WESTERN EUROPE-EU,ITALY,STANSTED,ALGHERO (FERTILIA), 5293 , 5293 , 0 , 6178 , 6178 , 0 ,-14.3250242797022 
05-May-2016 09:32,201603,WESTERN EUROPE-EU,ITALY,STANSTED,ANCONA, 8120 , 8120 , 0 , 6904 , 6904 , 0 , 17.6129779837775 
05-May-2016 09:32,201603,WESTERN EUROPE-EU,ITALY,STANSTED,BARI (PALESE), 10111 , 10111 , 0 , 9751 , 9751 , 0 , 3.6919290329197 
05-May-2016 09:32,201603,WESTERN EUROPE-EU,ITALY,STANSTED,BERGAMO, 41224 , 41224 , 0 , 42940 , 42940 , 0 ,-3.996273870517 
05-May-2016 09:32,201603,WESTERN EUROPE-EU,ITALY,STANSTED,BOLOGNA, 19665 , 19665 , 0 , 15617 , 15617 , 0 , 25.920471281296 
05-May-2016 09:32,201603,WESTERN EUROPE-EU,ITALY,STANSTED,BRINDISI, 5930 , 5930 , 0 , 4370 , 4370 , 0 , 35.6979405034325 
05-May-2016 09:32,201603,WESTERN EUROPE-EU,ITALY,STANSTED,CAGLIARI (ELMAS), 4968 , 4968 , 0 , 4270 , 4270 , 0 , 16.3466042154567 
05-May-2016 09:32,201603,WESTERN EUROPE-EU,ITALY,STANSTED,COMISO, 2556 , 2556 , 0 , 2637 , 2637 , 0 ,-3.07167235494881 
05-May-2016 09:32,201603,WESTERN EUROPE-EU,ITALY,STANSTED,GENOA, 6377 , 6377 , 0 , 4575 , 4575 , 0 , 39.3879781420765 
05-May-2016 09:32,201603,WESTERN EUROPE-EU,ITALY,STANSTED,LAMETIA-TERME, 4255 , 4255 , 0 , 4132 , 4132 , 0 , 2.97676669893514 
05-May-2016 09:32,201603,WESTERN EUROPE-EU,ITALY,STANSTED,MILAN (MALPENSA), 19613 , 19613 , 0 , 0 , 0 , 0 , 0 
05-May-2016 09:32,201603,WESTERN EUROPE-EU,ITALY,STANSTED,NAPLES, 11024 , 10834 , 190 , 9454 , 9454 , 0 , 16.606727311191 
05-May-2016 09:32,201603,WESTERN EUROPE-EU,ITALY,STANSTED,PALERMO, 8054 , 8054 , 0 , 6164 , 6164 , 0 , 30.6619078520441 
05-May-2016 09:32,201603,WESTERN EUROPE-EU,ITALY,STANSTED,PARMA, 3853 , 3853 , 0 , 4109 , 4109 , 0 ,-6.23022633244098 
05-May-2016 09:32,201603,WESTERN EUROPE-EU,ITALY,STANSTED,PERUGIA, 6878 , 6878 , 0 , 5890 , 5890 , 0 , 16.7741935483871 
05-May-2016 09:32,201603,WESTERN EUROPE-EU,ITALY,STANSTED,PESCARA, 7583 , 7583 , 0 , 7408 , 7408 , 0 , 2.36231101511879 
05-May-2016 09:32,201603,WESTERN EUROPE-EU,ITALY,STANSTED,PISA, 24430 , 24430 , 0 , 21986 , 21986 , 0 , 11.1161648321659 
05-May-2016 09:32,201603,WESTERN EUROPE-EU,ITALY,STANSTED,ROME (CIAMPINO), 52126 , 52126 , 0 , 42901 , 42901 , 0 , 21.5029952681756 
05-May-2016 09:32,201603,WESTERN EUROPE-EU,ITALY,STANSTED,TREVISO, 28253 , 28253 , 0 , 21711 , 21711 , 0 , 30.1321910552255 
05-May-2016 09:32,201603,WESTERN EUROPE-EU,ITALY,STANSTED,TRIESTE (RONCHI DEI LEGIONARI), 7076 , 7076 , 0 , 6492 , 6492 , 0 , 8.99568699938386 
05-May-2016 09:32,201603,WESTERN EUROPE-EU,ITALY,STANSTED,TURIN, 11870 , 10467 , 1403 , 12518 , 10716 , 1802 ,-5.17654577408532 
05-May-2016 09:32,201603,WESTERN EUROPE-EU,ITALY,STANSTED,VERONA VILLAFRANCA, 5627 , 5627 , 0 , 0 , 0 , 0 , 0 
05-May-2016 09:32,201603,CARIBBEAN AREA,JAMAICA,BIRMINGHAM,MONTEGO BAY, 5886 , 0 , 5886 , 4725 , 0 , 4725 , 24.5714285714286 
05-May-2016 09:32,201603,CARIBBEAN AREA,JAMAICA,CARDIFF WALES,MONTEGO BAY, 598 , 0 , 598 , 267 , 0 , 267 , 123.970037453184 
05-May-2016 09:32,201603,CARIBBEAN AREA,JAMAICA,DONCASTER SHEFFIELD,MONTEGO BAY, 0 , 0 , 0 , 435 , 0 , 435 , 0 
05-May-2016 09:32,201603,CARIBBEAN AREA,JAMAICA,EAST MIDLANDS INTERNATIONAL,MONTEGO BAY, 0 , 0 , 0 , 232 , 0 , 232 , 0 
05-May-2016 09:32,201603,CARIBBEAN AREA,JAMAICA,GATWICK,KINGSTON, 7282 , 7282 , 0 , 7029 , 7029 , 0 , 3.59937402190923 
05-May-2016 09:32,201603,CARIBBEAN AREA,JAMAICA,GATWICK,MONTEGO BAY, 18444 , 10036 , 8408 , 17445 , 9370 , 8075 , 5.72656921754084 
05-May-2016 09:32,201603,CARIBBEAN AREA,JAMAICA,GLASGOW,MONTEGO BAY, 0 , 0 , 0 , 527 , 0 , 527 , 0 
05-May-2016 09:32,201603,CARIBBEAN AREA,JAMAICA,MANCHESTER,MONTEGO BAY, 7102 , 0 , 7102 , 7691 , 2744 , 4947 ,-7.65830191132492 
05-May-2016 09:32,201603,CARIBBEAN AREA,JAMAICA,NEWCASTLE,MONTEGO BAY, 598 , 0 , 598 , 527 , 0 , 527 , 13.4724857685009 
05-May-2016 09:32,201603,CARIBBEAN AREA,JAMAICA,STANSTED,MONTEGO BAY, 289 , 0 , 289 , 0 , 0 , 0 , 0 
05-May-2016 09:32,201603,FAR EAST,JAPAN,HEATHROW,TOKYO (HANEDA), 39051 , 39051 , 0 , 37134 , 37134 , 0 , 5.1623848763936 
05-May-2016 09:32,201603,FAR EAST,JAPAN,HEATHROW,TOKYO (NARITA), 13367 , 13367 , 0 , 16660 , 16660 , 0 ,-19.765906362545 
05-May-2016 09:32,201603,NEAR EAST,JORDAN,HEATHROW,AMMAN, 16339 , 16339 , 0 , 15589 , 15589 , 0 , 4.81108473923921 
05-May-2016 09:32,201603,EASTERN EUROPE -OTHER,KAZAKHSTAN,HEATHROW,ALMATY, 0 , 0 , 0 , 2052 , 2052 , 0 , 0 
05-May-2016 09:32,201603,EASTERN EUROPE -OTHER,KAZAKHSTAN,HEATHROW,ASTANA, 2228 , 2228 , 0 , 1759 , 1759 , 0 , 26.6628766344514 
05-May-2016 09:32,201603,EAST AFRICA,KENYA,HEATHROW,NAIROBI, 24258 , 24258 , 0 , 22496 , 22496 , 0 , 7.83250355618777 
05-May-2016 09:32,201603,WESTERN EUROPE-OTHER,KOSOVO,GATWICK,PRISTINA, 873 , 873 , 0 , 867 , 867 , 0 , 0.69204152249135 
05-May-2016 09:32,201603,MIDDLE EAST,KUWAIT,HEATHROW,KUWAIT, 23507 , 23507 , 0 , 20596 , 20596 , 0 , 14.1338123907555 
05-May-2016 09:32,201603,EASTERN EUROPE-EU,LATVIA,DONCASTER SHEFFIELD,RIGA, 3537 , 3537 , 0 , 2625 , 2625 , 0 , 34.7428571428571 
05-May-2016 09:32,201603,EASTERN EUROPE-EU,LATVIA,EAST MIDLANDS INTERNATIONAL,RIGA, 5352 , 5352 , 0 , 5349 , 5349 , 0 , 5.60852495793606E-02 
05-May-2016 09:32,201603,EASTERN EUROPE-EU,LATVIA,GATWICK,RIGA, 7184 , 7184 , 0 , 6508 , 6508 , 0 , 10.3872157344806 
05-May-2016 09:32,201603,EASTERN EUROPE-EU,LATVIA,GLASGOW,RIGA, 1985 , 1985 , 0 , 1719 , 1719 , 0 , 15.4741128563118 
05-May-2016 09:32,201603,EASTERN EUROPE-EU,LATVIA,LEEDS BRADFORD,RIGA, 3106 , 3106 , 0 , 2875 , 2875 , 0 , 8.03478260869565 
05-May-2016 09:32,201603,EASTERN EUROPE-EU,LATVIA,LIVERPOOL (JOHN LENNON),RIGA, 2348 , 2348 , 0 , 0 , 0 , 0 , 0 
05-May-2016 09:32,201603,EASTERN EUROPE-EU,LATVIA,LUTON,RIGA, 14164 , 14164 , 0 , 9739 , 9739 , 0 , 45.4358763733443 
05-May-2016 09:32,201603,EASTERN EUROPE-EU,LATVIA,MANCHESTER,RIGA, 4834 , 4834 , 0 , 4258 , 4258 , 0 , 13.5274776890559 
05-May-2016 09:32,201603,EASTERN EUROPE-EU,LATVIA,STANSTED,RIGA, 21891 , 21891 , 0 , 21487 , 21487 , 0 , 1.88020663657095 
05-May-2016 09:32,201603,NEAR EAST,LEBANON,HEATHROW,BEIRUT, 18963 , 18963 , 0 , 16992 , 16992 , 0 , 11.5995762711864 
05-May-2016 09:32,201603,EASTERN EUROPE-EU,LITHUANIA,ABERDEEN,VILNIUS, 0 , 0 , 0 , 3 , 0 , 3 , 0 
05-May-2016 09:32,201603,EASTERN EUROPE-EU,LITHUANIA,BELFAST INTERNATIONAL,VILNIUS, 1829 , 1829 , 0 , 0 , 0 , 0 , 0 
05-May-2016 09:32,201603,EASTERN EUROPE-EU,LITHUANIA,BIRMINGHAM,KAUNAS, 2704 , 2704 , 0 , 2677 , 2677 , 0 , 1.00859170713485 
05-May-2016 09:32,201603,EASTERN EUROPE-EU,LITHUANIA,BIRMINGHAM,VILNIUS, 331 , 331 , 0 , 0 , 0 , 0 , 0 
05-May-2016 09:32,201603,EASTERN EUROPE-EU,LITHUANIA,BRISTOL,KAUNAS, 2817 , 2817 , 0 , 3004 , 3004 , 0 ,-6.22503328894807 
05-May-2016 09:32,201603,EASTERN EUROPE-EU,LITHUANIA,DONCASTER SHEFFIELD,VILNIUS, 3426 , 3426 , 0 , 2656 , 2656 , 0 , 28.9909638554217 
05-May-2016 09:32,201603,EASTERN EUROPE-EU,LITHUANIA,EDINBURGH,KAUNAS, 0 , 0 , 0 , 348 , 348 , 0 , 0 
05-May-2016 09:32,201603,EASTERN EUROPE-EU,LITHUANIA,GATWICK,KAUNAS, 4694 , 4694 , 0 , 4632 , 4632 , 0 , 1.33851468048359 
05-May-2016 09:32,201603,EASTERN EUROPE-EU,LITHUANIA,GLASGOW,VILNIUS, 1793 , 1793 , 0 , 0 , 0 , 0 , 0 
05-May-2016 09:32,201603,EASTERN EUROPE-EU,LITHUANIA,LIVERPOOL (JOHN LENNON),VILNIUS, 3131 , 3131 , 0 , 3008 , 3008 , 0 , 4.08909574468085 
05-May-2016 09:32,201603,EASTERN EUROPE-EU,LITHUANIA,LUTON,KAUNAS, 7838 , 7838 , 0 , 6184 , 6184 , 0 , 26.7464424320828 
05-May-2016 09:32,201603,EASTERN EUROPE-EU,LITHUANIA,LUTON,PALANGA, 849 , 849 , 0 , 0 , 0 , 0 , 0 
05-May-2016 09:32,201603,EASTERN EUROPE-EU,LITHUANIA,LUTON,VILNIUS, 21056 , 21056 , 0 , 16975 , 16975 , 0 , 24.0412371134021 
05-May-2016 09:32,201603,EASTERN EUROPE-EU,LITHUANIA,STANSTED,KAUNAS, 9373 , 9373 , 0 , 11135 , 11135 , 0 ,-15.8239784463404 
05-May-2016 09:32,201603,EASTERN EUROPE-EU,LITHUANIA,STANSTED,PALANGA, 351 , 351 , 0 , 0 , 0 , 0 , 0 
05-May-2016 09:32,201603,EASTERN EUROPE-EU,LITHUANIA,STANSTED,VILNIUS, 10913 , 10913 , 0 , 10829 , 10829 , 0 , 0.775694893341952 
05-May-2016 09:32,201603,WESTERN EUROPE-EU,LUXEMBOURG,GATWICK,LUXEMBOURG, 5874 , 5874 , 0 , 4929 , 4929 , 0 , 19.1722458916616 
05-May-2016 09:32,201603,WESTERN EUROPE-EU,LUXEMBOURG,HEATHROW,LUXEMBOURG, 12320 , 12320 , 0 , 10492 , 10492 , 0 , 17.4227983225315 
05-May-2016 09:32,201603,WESTERN EUROPE-EU,LUXEMBOURG,LONDON CITY,LUXEMBOURG, 14977 , 14977 , 0 , 15956 , 15956 , 0 ,-6.13562296314866 
05-May-2016 09:32,201603,WESTERN EUROPE-EU,LUXEMBOURG,LUTON,LUXEMBOURG, 6 , 0 , 6 , 0 , 0 , 0 , 0 
05-May-2016 09:32,201603,WESTERN EUROPE-EU,LUXEMBOURG,PRESTWICK,LUXEMBOURG, 3 , 3 , 0 , 0 , 0 , 0 , 0 
05-May-2016 09:32,201603,WESTERN EUROPE-OTHER,MACEDONIA,LUTON,OHRID, 421 , 421 , 0 , 0 , 0 , 0 , 0 
05-May-2016 09:32,201603,WESTERN EUROPE-OTHER,MACEDONIA,LUTON,SKOPJE, 6304 , 6304 , 0 , 5301 , 5301 , 0 , 18.9209583097529 
05-May-2016 09:32,201603,FAR EAST,MALAYSIA,HEATHROW,KUALA LUMPUR (SEPANG), 45586 , 45586 , 0 , 43999 , 43999 , 0 , 3.60690015682175 
05-May-2016 09:32,201603,INDIAN OCEAN ISLANDS,MALDIVE ISLANDS,GATWICK,MALE INTERNATIONAL, 5936 , 5936 , 0 , 0 , 0 , 0 , 0 
05-May-2016 09:32,201603,WESTERN EUROPE-EU,MALTA,BELFAST INTERNATIONAL,MALTA, 0 , 0 , 0 , 2423 , 2423 , 0 , 0 
05-May-2016 09:32,201603,WESTERN EUROPE-EU,MALTA,BIRMINGHAM,MALTA, 3970 , 3821 , 149 , 3170 , 3170 , 0 , 25.2365930599369 
05-May-2016 09:32,201603,WESTERN EUROPE-EU,MALTA,BOURNEMOUTH,MALTA, 1170 , 1170 , 0 , 238 , 238 , 0 , 391.596638655462 
05-May-2016 09:32,201603,WESTERN EUROPE-EU,MALTA,BRISTOL,MALTA, 3529 , 3529 , 0 , 3171 , 3171 , 0 , 11.2898139388206 
05-May-2016 09:32,201603,WESTERN EUROPE-EU,MALTA,EAST MIDLANDS INTERNATIONAL,MALTA, 2824 , 2824 , 0 , 2712 , 2712 , 0 , 4.12979351032448 
05-May-2016 09:32,201603,WESTERN EUROPE-EU,MALTA,EDINBURGH,MALTA, 4904 , 4904 , 0 , 3604 , 3604 , 0 , 36.0710321864595 
05-May-2016 09:32,201603,WESTERN EUROPE-EU,MALTA,GATWICK,MALTA, 29177 , 27300 , 1877 , 27908 , 26198 , 1710 , 4.5470832736133 
05-May-2016 09:32,201603,WESTERN EUROPE-EU,MALTA,HEATHROW,MALTA, 14241 , 14241 , 0 , 14881 , 14881 , 0 ,-4.30078623748404 
05-May-2016 09:32,201603,WESTERN EUROPE-EU,MALTA,LEEDS BRADFORD,MALTA, 2975 , 2833 , 142 , 3148 , 3148 , 0 ,-5.49555273189327 
05-May-2016 09:32,201603,WESTERN EUROPE-EU,MALTA,LIVERPOOL (JOHN LENNON),MALTA, 2708 , 2708 , 0 , 3074 , 3074 , 0 ,-11.9063109954457 
05-May-2016 09:32,201603,WESTERN EUROPE-EU,MALTA,LUTON,MALTA, 9504 , 9338 , 166 , 6376 , 6376 , 0 , 49.0589711417817 
05-May-2016 09:32,201603,WESTERN EUROPE-EU,MALTA,MANCHESTER,MALTA, 14487 , 10514 , 3973 , 11785 , 8038 , 3747 , 22.9274501484938 
05-May-2016 09:32,201603,WESTERN EUROPE-EU,MALTA,NEWCASTLE,MALTA, 2899 , 2899 , 0 , 2684 , 2684 , 0 , 8.01043219076006 
05-May-2016 09:32,201603,WESTERN EUROPE-EU,MALTA,PRESTWICK,MALTA, 882 , 882 , 0 , 0 , 0 , 0 , 0 
05-May-2016 09:32,201603,WESTERN EUROPE-EU,MALTA,STANSTED,MALTA, 6245 , 6245 , 0 , 4521 , 4521 , 0 , 38.1331563813316 
05-May-2016 09:32,201603,INDIAN OCEAN ISLANDS,MAURITIUS,GATWICK,MAURITIUS, 8992 , 8992 , 0 , 8957 , 8957 , 0 , 0.39075583342637 
05-May-2016 09:32,201603,INDIAN OCEAN ISLANDS,MAURITIUS,HEATHROW,MAURITIUS, 4932 , 4932 , 0 , 5313 , 5313 , 0 ,-7.17108977978543 
05-May-2016 09:32,201603,CENTRAL AMERICA,MEXICO,BIRMINGHAM,CANCUN, 4831 , 0 , 4831 , 3083 , 0 , 3083 , 56.6980214077198 
05-May-2016 09:32,201603,CENTRAL AMERICA,MEXICO,GATWICK,CANCUN, 30401 , 19219 , 11182 , 28746 , 18179 , 10567 , 5.75732275794893 
05-May-2016 09:32,201603,CENTRAL AMERICA,MEXICO,GATWICK,COZUMEL, 454 , 0 , 454 , 0 , 0 , 0 , 0 
05-May-2016 09:32,201603,CENTRAL AMERICA,MEXICO,GATWICK,PUERTO VALLARTA, 2303 , 0 , 2303 , 2540 , 0 , 2540 ,-9.33070866141732 
05-May-2016 09:32,201603,CENTRAL AMERICA,MEXICO,HEATHROW,MEXICO CITY, 17046 , 17046 , 0 , 16097 , 16097 , 0 , 5.89550847984096 
05-May-2016 09:32,201603,CENTRAL AMERICA,MEXICO,MANCHESTER,CANCUN, 16088 , 6840 , 9248 , 15795 , 5565 , 10230 , 1.85501741057297 
05-May-2016 09:32,201603,CENTRAL AMERICA,MEXICO,MANCHESTER,PUERTO VALLARTA, 2199 , 0 , 2199 , 1771 , 0 , 1771 , 24.1671372106155 
05-May-2016 09:32,201603,CENTRAL AMERICA,MEXICO,NEWCASTLE,CANCUN, 297 , 0 , 297 , 290 , 0 , 290 , 2.41379310344828 
05-May-2016 09:32,201603,NORTH AFRICA,MOROCCO,BIRMINGHAM,MARRAKESH, 817 , 817 , 0 , 205 , 205 , 0 , 298.536585365854 
05-May-2016 09:32,201603,NORTH AFRICA,MOROCCO,BRISTOL,MARRAKESH, 3042 , 3042 , 0 , 2663 , 2663 , 0 , 14.2320690950056 
05-May-2016 09:32,201603,NORTH AFRICA,MOROCCO,GATWICK,AGADIR (AL MASSIRA), 8099 , 8099 , 0 , 8066 , 7804 , 262 , 0.409124721051327 
05-May-2016 09:32,201603,NORTH AFRICA,MOROCCO,GATWICK,CASABLANCA MOHAMED V, 2851 , 2851 , 0 , 3463 , 3463 , 0 ,-17.6725382616229 
05-May-2016 09:32,201603,NORTH AFRICA,MOROCCO,GATWICK,MARRAKESH, 32003 , 32003 , 0 , 32762 , 32762 , 0 ,-2.31670838166168 
05-May-2016 09:32,201603,NORTH AFRICA,MOROCCO,GATWICK,RABAT, 1503 , 1503 , 0 , 0 , 0 , 0 , 0 
05-May-2016 09:32,201603,NORTH AFRICA,MOROCCO,GATWICK,TANGIERS (IBN BATUTA), 1721 , 1721 , 0 , 1880 , 1880 , 0 ,-8.45744680851064 
05-May-2016 09:32,201603,NORTH AFRICA,MOROCCO,GLASGOW,MARRAKESH, 3041 , 3041 , 0 , 2963 , 2963 , 0 , 2.63246709416132 
05-May-2016 09:32,201603,NORTH AFRICA,MOROCCO,HEATHROW,CASABLANCA MOHAMED V, 7258 , 7258 , 0 , 7600 , 7600 , 0 ,-4.5 
05-May-2016 09:32,201603,NORTH AFRICA,MOROCCO,LUTON,ESSAOUIRA, 2498 , 2498 , 0 , 0 , 0 , 0 , 0 
05-May-2016 09:32,201603,NORTH AFRICA,MOROCCO,LUTON,MARRAKESH, 4260 , 4111 , 149 , 3359 , 3359 , 0 , 26.8234593629056 
05-May-2016 09:32,201603,NORTH AFRICA,MOROCCO,MANCHESTER,AGADIR (AL MASSIRA), 5143 , 5143 , 0 , 4311 , 4311 , 0 , 19.2994664810949 
05-May-2016 09:32,201603,NORTH AFRICA,MOROCCO,MANCHESTER,MARRAKESH, 8027 , 8027 , 0 , 7701 , 7701 , 0 , 4.2332164653941 
05-May-2016 09:32,201603,NORTH AFRICA,MOROCCO,STANSTED,FEZ, 2615 , 2615 , 0 , 2799 , 2799 , 0 ,-6.57377634869596 
05-May-2016 09:32,201603,NORTH AFRICA,MOROCCO,STANSTED,MARRAKESH, 10565 , 10565 , 0 , 16473 , 16473 , 0 ,-35.8647483761306 
05-May-2016 09:32,201603,NORTH AFRICA,MOROCCO,STANSTED,RABAT, 4643 , 4643 , 0 , 4428 , 4428 , 0 , 4.85546522131888 
05-May-2016 09:32,201603,WESTERN EUROPE-EU,NETHERLANDS,ABERDEEN,AMSTERDAM, 23035 , 23035 , 0 , 22736 , 22736 , 0 , 1.31509500351865 
05-May-2016 09:32,201603,WESTERN EUROPE-EU,NETHERLANDS,BELFAST CITY (GEORGE BEST),AMSTERDAM, 3631 , 3631 , 0 , 0 , 0 , 0 , 0 
05-May-2016 09:32,201603,WESTERN EUROPE-EU,NETHERLANDS,BELFAST INTERNATIONAL,AMSTERDAM, 9472 , 9472 , 0 , 7514 , 7514 , 0 , 26.0580250199627 
05-May-2016 09:32,201603,WESTERN EUROPE-EU,NETHERLANDS,BIGGIN HILL,ROTTERDAM, 0 , 0 , 0 , 128 , 0 , 128 , 0 
05-May-2016 09:32,201603,WESTERN EUROPE-EU,NETHERLANDS,BIRMINGHAM,AMSTERDAM, 51107 , 51107 , 0 , 43098 , 43098 , 0 , 18.5832289201355 
05-May-2016 09:32,201603,WESTERN EUROPE-EU,NETHERLANDS,BIRMINGHAM,ROTTERDAM, 0 , 0 , 0 , 116 , 0 , 116 , 0 
05-May-2016 09:32,201603,WESTERN EUROPE-EU,NETHERLANDS,BOURNEMOUTH,AMSTERDAM, 630 , 630 , 0 , 187 , 0 , 187 , 236.898395721925 
05-May-2016 09:32,201603,WESTERN EUROPE-EU,NETHERLANDS,BRISTOL,AMSTERDAM, 33894 , 33894 , 0 , 29914 , 29914 , 0 , 13.304807113726 
05-May-2016 09:32,201603,WESTERN EUROPE-EU,NETHERLANDS,CAMBRIDGE,GRONINGEN, 0 , 0 , 0 , 235 , 235 , 0 , 0 
05-May-2016 09:32,201603,WESTERN EUROPE-EU,NETHERLANDS,CARDIFF WALES,AMSTERDAM, 11776 , 11776 , 0 , 10847 , 10847 , 0 , 8.56458006822163 
05-May-2016 09:32,201603,WESTERN EUROPE-EU,NETHERLANDS,DONCASTER SHEFFIELD,AMSTERDAM, 1447 , 1447 , 0 , 0 , 0 , 0 , 0 
05-May-2016 09:32,201603,WESTERN EUROPE-EU,NETHERLANDS,DURHAM TEES VALLEY,AMSTERDAM, 9654 , 9654 , 0 , 9243 , 9243 , 0 , 4.4466082440766 
05-May-2016 09:32,201603,WESTERN EUROPE-EU,NETHERLANDS,DURHAM TEES VALLEY,MAASTRICHT, 0 , 0 , 0 , 22 , 0 , 22 , 0 
05-May-2016 09:32,201603,WESTERN EUROPE-EU,NETHERLANDS,EAST MIDLANDS INTERNATIONAL,AMSTERDAM, 4289 , 4289 , 0 , 3909 , 3909 , 0 , 9.72115630596061 
05-May-2016 09:32,201603,WESTERN EUROPE-EU,NETHERLANDS,EDINBURGH,AMSTERDAM, 49899 , 49899 , 0 , 44295 , 44295 , 0 , 12.65154080596 
05-May-2016 09:32,201603,WESTERN EUROPE-EU,NETHERLANDS,EXETER,AMSTERDAM, 3927 , 3927 , 0 , 3380 , 3380 , 0 , 16.1834319526627 
05-May-2016 09:32,201603,WESTERN EUROPE-EU,NETHERLANDS,GATWICK,AMSTERDAM, 90893 , 90893 , 0 , 74834 , 74834 , 0 , 21.4594970200711 
05-May-2016 09:32,201603,WESTERN EUROPE-EU,NETHERLANDS,GLASGOW,AMSTERDAM, 33883 , 33883 , 0 , 31627 , 31627 , 0 , 7.13314572991431 
05-May-2016 09:32,201603,WESTERN EUROPE-EU,NETHERLANDS,HEATHROW,AMSTERDAM, 131487 , 131487 , 0 , 120052 , 120052 , 0 , 9.5250391497018 
05-May-2016 09:32,201603,WESTERN EUROPE-EU,NETHERLANDS,HEATHROW,ROTTERDAM, 0 , 0 , 0 , 5949 , 5949 , 0 , 0 
05-May-2016 09:32,201603,WESTERN EUROPE-EU,NETHERLANDS,HUMBERSIDE,AMSTERDAM, 10610 , 10610 , 0 , 10676 , 10676 , 0 ,-0.618209067066317 
05-May-2016 09:32,201603,WESTERN EUROPE-EU,NETHERLANDS,INVERNESS,AMSTERDAM, 2315 , 2308 , 7 , 2157 , 2157 , 0 , 7.32498840982847 
05-May-2016 09:32,201603,WESTERN EUROPE-EU,NETHERLANDS,LEEDS BRADFORD,AMSTERDAM, 21429 , 21429 , 0 , 20715 , 20715 , 0 , 3.44677769732078 
05-May-2016 09:32,201603,WESTERN EUROPE-EU,NETHERLANDS,LEEDS BRADFORD,ROTTERDAM, 96 , 0 , 96 , 0 , 0 , 0 , 0 
05-May-2016 09:32,201603,WESTERN EUROPE-EU,NETHERLANDS,LIVERPOOL (JOHN LENNON),AMSTERDAM, 26759 , 26759 , 0 , 19376 , 19376 , 0 , 38.1038398018167 
05-May-2016 09:32,201603,WESTERN EUROPE-EU,NETHERLANDS,LONDON CITY,AMSTERDAM, 45532 , 45532 , 0 , 40329 , 40329 , 0 , 12.901386099333 
05-May-2016 09:32,201603,WESTERN EUROPE-EU,NETHERLANDS,LONDON CITY,ROTTERDAM, 18343 , 18343 , 0 , 15953 , 15953 , 0 , 14.9815081802796 
05-May-2016 09:32,201603,WESTERN EUROPE-EU,NETHERLANDS,LUTON,AMSTERDAM, 45502 , 45302 , 200 , 38223 , 38223 , 0 , 19.0435078355964 
05-May-2016 09:32,201603,WESTERN EUROPE-EU,NETHERLANDS,MANCHESTER,AMSTERDAM, 82249 , 82249 , 0 , 66518 , 66518 , 0 , 23.6492378002947 
05-May-2016 09:32,201603,WESTERN EUROPE-EU,NETHERLANDS,MANCHESTER,EINDHOVEN, 5382 , 5382 , 0 , 5211 , 5211 , 0 , 3.28151986183074 
05-May-2016 09:32,201603,WESTERN EUROPE-EU,NETHERLANDS,MANCHESTER,ROTTERDAM, 3144 , 3144 , 0 , 100 , 0 , 100 , 3044 
05-May-2016 09:32,201603,WESTERN EUROPE-EU,NETHERLANDS,NEWCASTLE,AMSTERDAM, 30497 , 30497 , 0 , 31105 , 31105 , 0 ,-1.95466966725607 
05-May-2016 09:32,201603,WESTERN EUROPE-EU,NETHERLANDS,NORWICH,AMSTERDAM, 11496 , 11496 , 0 , 11002 , 11002 , 0 , 4.49009271041629 
05-May-2016 09:32,201603,WESTERN EUROPE-EU,NETHERLANDS,SOUTHAMPTON,AMSTERDAM, 13023 , 13023 , 0 , 10235 , 10235 , 0 , 27.2398632144602 
05-May-2016 09:32,201603,WESTERN EUROPE-EU,NETHERLANDS,SOUTHEND,AMSTERDAM, 17177 , 17177 , 0 , 19020 , 19020 , 0 ,-9.68980021030494 
05-May-2016 09:32,201603,WESTERN EUROPE-EU,NETHERLANDS,SOUTHEND,GRONINGEN, 2299 , 2299 , 0 , 1383 , 1383 , 0 , 66.232827187274 
05-May-2016 09:32,201603,WESTERN EUROPE-EU,NETHERLANDS,STANSTED,AMSTERDAM, 27392 , 27392 , 0 , 24603 , 24603 , 0 , 11.3360159330163 
05-May-2016 09:32,201603,WESTERN EUROPE-EU,NETHERLANDS,STANSTED,EINDHOVEN, 25507 , 25507 , 0 , 22356 , 22356 , 0 , 14.0946502057613 
05-May-2016 09:32,201603,AUSTRALASIA,NEW ZEALAND,HEATHROW,AUCKLAND INTERNATIONAL, 1159 , 1159 , 0 , 10211 , 10211 , 0 ,-88.6494956419548 
05-May-2016 09:32,201603,WEST AFRICA,NIGERIA,HEATHROW,ABUJA, 8120 , 8120 , 0 , 9667 , 9667 , 0 ,-16.0028964518465 
05-May-2016 09:32,201603,WEST AFRICA,NIGERIA,HEATHROW,LAGOS, 31662 , 31662 , 0 , 34425 , 34425 , 0 ,-8.02614379084967 
05-May-2016 09:32,201603,WESTERN EUROPE-OTHER,NORWAY,ABERDEEN,BERGEN, 2440 , 2440 , 0 , 4066 , 4066 , 0 ,-39.9901623216921 
05-May-2016 09:32,201603,WESTERN EUROPE-OTHER,NORWAY,ABERDEEN,HAUGESUND, 82 , 0 , 82 , 0 , 0 , 0 , 0 
05-May-2016 09:32,201603,WESTERN EUROPE-OTHER,NORWAY,ABERDEEN,OSLO (GARDERMOEN), 2415 , 2415 , 0 , 3000 , 3000 , 0 ,-19.5 
05-May-2016 09:32,201603,WESTERN EUROPE-OTHER,NORWAY,ABERDEEN,STAVANGER, 7682 , 7682 , 0 , 10813 , 10813 , 0 ,-28.9558864329973 
05-May-2016 09:32,201603,WESTERN EUROPE-OTHER,NORWAY,BIRMINGHAM,OSLO (GARDERMOEN), 0 , 0 , 0 , 1743 , 1743 , 0 , 0 
05-May-2016 09:32,201603,WESTERN EUROPE-OTHER,NORWAY,BOURNEMOUTH,BERGEN, 0 , 0 , 0 , 225 , 0 , 225 , 0 
05-May-2016 09:32,201603,WESTERN EUROPE-OTHER,NORWAY,BOURNEMOUTH,TROMSOE, 0 , 0 , 0 , 282 , 0 , 282 , 0 
05-May-2016 09:32,201603,WESTERN EUROPE-OTHER,NORWAY,BRISTOL,BERGEN, 0 , 0 , 0 , 264 , 0 , 264 , 0 
05-May-2016 09:32,201603,WESTERN EUROPE-OTHER,NORWAY,BRISTOL,TROMSOE, 288 , 0 , 288 , 0 , 0 , 0 , 0 
05-May-2016 09:32,201603,WESTERN EUROPE-OTHER,NORWAY,EAST MIDLANDS INTERNATIONAL,TROMSOE, 293 , 0 , 293 , 0 , 0 , 0 , 0 
05-May-2016 09:32,201603,WESTERN EUROPE-OTHER,NORWAY,EDINBURGH,OSLO (GARDERMOEN), 5853 , 5853 , 0 , 3864 , 3705 , 159 , 51.4751552795031 
05-May-2016 09:32,201603,WESTERN EUROPE-OTHER,NORWAY,EDINBURGH,RYGGE, 3400 , 3400 , 0 , 3295 , 3295 , 0 , 3.1866464339909 
05-May-2016 09:32,201603,WESTERN EUROPE-OTHER,NORWAY,GATWICK,ALESUND, 283 , 283 , 0 , 2359 , 2359 , 0 ,-88.0033912674862 
05-May-2016 09:32,201603,WESTERN EUROPE-OTHER,NORWAY,GATWICK,BERGEN, 15936 , 15936 , 0 , 13024 , 12680 , 344 , 22.3587223587224 
05-May-2016 09:32,201603,WESTERN EUROPE-OTHER,NORWAY,GATWICK,BODO, 142 , 0 , 142 , 453 , 0 , 453 ,-68.6534216335541 
05-May-2016 09:32,201603,WESTERN EUROPE-OTHER,NORWAY,GATWICK,EVENES, 619 , 0 , 619 , 0 , 0 , 0 , 0 
05-May-2016 09:32,201603,WESTERN EUROPE-OTHER,NORWAY,GATWICK,FAGERNES/LEIRIN, 122 , 0 , 122 , 395 , 0 , 395 ,-69.1139240506329 
05-May-2016 09:32,201603,WESTERN EUROPE-OTHER,NORWAY,GATWICK,OSLO (GARDERMOEN), 29646 , 29646 , 0 , 28632 , 28632 , 0 , 3.54149203688181 
05-May-2016 09:32,201603,WESTERN EUROPE-OTHER,NORWAY,GATWICK,SANDEFJORD(TORP), 0 , 0 , 0 , 3714 , 3714 , 0 , 0 
05-May-2016 09:32,201603,WESTERN EUROPE-OTHER,NORWAY,GATWICK,STAVANGER, 6147 , 6147 , 0 , 4906 , 4906 , 0 , 25.2955564614757 
05-May-2016 09:32,201603,WESTERN EUROPE-OTHER,NORWAY,GATWICK,TROMSOE, 3909 , 2687 , 1222 , 3111 , 2451 , 660 , 25.6509161041466 
05-May-2016 09:32,201603,WESTERN EUROPE-OTHER,NORWAY,GATWICK,TRONDHEIM (VAERNES), 5501 , 5501 , 0 , 4614 , 4614 , 0 , 19.2241005635024 
05-May-2016 09:32,201603,WESTERN EUROPE-OTHER,NORWAY,GLASGOW,TROMSOE, 0 , 0 , 0 , 194 , 0 , 194 , 0 
05-May-2016 09:32,201603,WESTERN EUROPE-OTHER,NORWAY,HEATHROW,BERGEN, 10779 , 10779 , 0 , 10959 , 10959 , 0 ,-1.64248562825075 
05-May-2016 09:32,201603,WESTERN EUROPE-OTHER,NORWAY,HEATHROW,OSLO (GARDERMOEN), 58741 , 58741 , 0 , 58607 , 58607 , 0 , 0.228641629839439 
05-May-2016 09:32,201603,WESTERN EUROPE-OTHER,NORWAY,HEATHROW,STAVANGER, 14963 , 14963 , 0 , 16971 , 16971 , 0 ,-11.8319486182311 
05-May-2016 09:32,201603,WESTERN EUROPE-OTHER,NORWAY,LIVERPOOL (JOHN LENNON),SANDEFJORD(TORP), 3466 , 3466 , 0 , 3029 , 3029 , 0 , 14.42720369759 
05-May-2016 09:32,201603,WESTERN EUROPE-OTHER,NORWAY,LIVERPOOL (JOHN LENNON),STAVANGER, 0 , 0 , 0 , 155 , 0 , 155 , 0 
05-May-2016 09:32,201603,WESTERN EUROPE-OTHER,NORWAY,MANCHESTER,BERGEN, 977 , 977 , 0 , 1701 , 1212 , 489 ,-42.5631981187537 
05-May-2016 09:32,201603,WESTERN EUROPE-OTHER,NORWAY,MANCHESTER,OSLO (GARDERMOEN), 8533 , 8533 , 0 , 7918 , 7918 , 0 , 7.76711290729982 
05-May-2016 09:32,201603,WESTERN EUROPE-OTHER,NORWAY,MANCHESTER,RYGGE, 5323 , 5323 , 0 , 5347 , 5347 , 0 ,-0.448849822330279 
05-May-2016 09:32,201603,WESTERN EUROPE-OTHER,NORWAY,MANCHESTER,STAVANGER, 2191 , 2191 , 0 , 1624 , 1624 , 0 , 34.9137931034483 
05-May-2016 09:32,201603,WESTERN EUROPE-OTHER,NORWAY,MANCHESTER,TROMSOE, 141 , 0 , 141 , 424 , 0 , 424 ,-66.7452830188679 
05-May-2016 09:32,201603,WESTERN EUROPE-OTHER,NORWAY,NEWCASTLE,BERGEN, 0 , 0 , 0 , 98 , 0 , 98 , 0 
05-May-2016 09:32,201603,WESTERN EUROPE-OTHER,NORWAY,NEWCASTLE,STAVANGER, 272 , 272 , 0 , 1175 , 1175 , 0 ,-76.8510638297872 
05-May-2016 09:32,201603,WESTERN EUROPE-OTHER,NORWAY,NEWCASTLE,TROMSOE, 280 , 0 , 280 , 146 , 0 , 146 , 91.7808219178082 
05-May-2016 09:32,201603,WESTERN EUROPE-OTHER,NORWAY,STANSTED,HAUGESUND, 0 , 0 , 0 , 2534 , 2534 , 0 , 0 
05-May-2016 09:32,201603,WESTERN EUROPE-OTHER,NORWAY,STANSTED,OSLO (GARDERMOEN), 97 , 0 , 97 , 0 , 0 , 0 , 0 
05-May-2016 09:32,201603,WESTERN EUROPE-OTHER,NORWAY,STANSTED,RYGGE, 25208 , 25208 , 0 , 23416 , 23416 , 0 , 7.65288691492996 
05-May-2016 09:32,201603,WESTERN EUROPE-OTHER,NORWAY,STANSTED,SANDEFJORD(TORP), 6608 , 6608 , 0 , 6961 , 6961 , 0 ,-5.07111047263324 
05-May-2016 09:32,201603,WESTERN EUROPE-OTHER,NORWAY,SUMBURGH,BERGEN, 8 , 8 , 0 , 0 , 0 , 0 , 0 
05-May-2016 09:32,201603,WESTERN EUROPE-OTHER,NORWAY,SUMBURGH,HAUGESUND, 24 , 24 , 0 , 0 , 0 , 0 , 0 
05-May-2016 09:32,201603,WESTERN EUROPE-OTHER,NORWAY,WICK JOHN O GROATS,ALESUND, 0 , 0 , 0 , 54 , 0 , 54 , 0 
05-May-2016 09:32,201603,OIL RIGS,OIL RIGS,ABERDEEN,OIL RIGS, 33774 , 0 , 33774 , 43921 , 0 , 43921 ,-23.1028437421734 
05-May-2016 09:32,201603,OIL RIGS,OIL RIGS,BLACKPOOL,OIL RIGS, 1717 , 0 , 1717 , 1994 , 0 , 1994 ,-13.8916750250752 
05-May-2016 09:32,201603,OIL RIGS,OIL RIGS,HUMBERSIDE,OIL RIGS, 2621 , 0 , 2621 , 4356 , 0 , 4356 ,-39.8301193755739 
05-May-2016 09:32,201603,OIL RIGS,OIL RIGS,INVERNESS,OIL RIGS, 0 , 0 , 0 , 90 , 0 , 90 , 0 
05-May-2016 09:32,201603,OIL RIGS,OIL RIGS,NORWICH,OIL RIGS, 8860 , 0 , 8860 , 7097 , 0 , 7097 , 24.8414823164718 
05-May-2016 09:32,201603,OIL RIGS,OIL RIGS,SCATSTA,OIL RIGS, 6462 , 0 , 6462 , 10946 , 0 , 10946 ,-40.9647359766125 
05-May-2016 09:32,201603,OIL RIGS,OIL RIGS,SUMBURGH,OIL RIGS, 3509 , 0 , 3509 , 1433 , 0 , 1433 , 144.870900209351 
05-May-2016 09:32,201603,MIDDLE EAST,OMAN,GATWICK,MUSCAT, 0 , 0 , 0 , 536 , 0 , 536 , 0 
05-May-2016 09:32,201603,MIDDLE EAST,OMAN,HEATHROW,MUSCAT, 15755 , 15755 , 0 , 15424 , 15424 , 0 , 2.14600622406639 
05-May-2016 09:32,201603,INDIAN SUB-CONTINENT,PAKISTAN,BIRMINGHAM,ISLAMABAD, 7134 , 7134 , 0 , 7247 , 7247 , 0 ,-1.55926590313233 
05-May-2016 09:32,201603,INDIAN SUB-CONTINENT,PAKISTAN,GATWICK,ISLAMABAD, 80 , 80 , 0 , 128 , 0 , 128 ,-37.5 
05-May-2016 09:32,201603,INDIAN SUB-CONTINENT,PAKISTAN,HEATHROW,ISLAMABAD, 8802 , 8802 , 0 , 10694 , 10694 , 0 ,-17.6921638301852 
05-May-2016 09:32,201603,INDIAN SUB-CONTINENT,PAKISTAN,HEATHROW,KARACHI, 3966 , 3966 , 0 , 2699 , 2699 , 0 , 46.9433123379029 
05-May-2016 09:32,201603,INDIAN SUB-CONTINENT,PAKISTAN,HEATHROW,LAHORE, 6494 , 6494 , 0 , 8155 , 8155 , 0 ,-20.3678724708768 
05-May-2016 09:32,201603,INDIAN SUB-CONTINENT,PAKISTAN,MANCHESTER,ISLAMABAD, 15981 , 15981 , 0 , 13211 , 13211 , 0 , 20.9673756717887 
05-May-2016 09:32,201603,INDIAN SUB-CONTINENT,PAKISTAN,MANCHESTER,KARACHI, 116 , 116 , 0 , 132 , 132 , 0 ,-12.1212121212121 
05-May-2016 09:32,201603,INDIAN SUB-CONTINENT,PAKISTAN,MANCHESTER,LAHORE, 4301 , 4301 , 0 , 4017 , 4017 , 0 , 7.06995270102066 
05-May-2016 09:32,201603,FAR EAST,PHILIPPINES,HEATHROW,MANILA, 7229 , 7229 , 0 , 6515 , 6515 , 0 , 10.9593246354566 
05-May-2016 09:32,201603,EASTERN EUROPE-EU,POLAND,ABERDEEN,GDANSK, 2429 , 2429 , 0 , 0 , 0 , 0 , 0 
05-May-2016 09:32,201603,EASTERN EUROPE-EU,POLAND,BELFAST INTERNATIONAL,KATOWICE, 2045 , 2045 , 0 , 266 , 266 , 0 , 668.796992481203 
05-May-2016 09:32,201603,EASTERN EUROPE-EU,POLAND,BELFAST INTERNATIONAL,KRAKOW, 4255 , 4255 , 0 , 4082 , 4082 , 0 , 4.23811856932876 
05-May-2016 09:32,201603,EASTERN EUROPE-EU,POLAND,BIRMINGHAM,BYDGOSZCZ, 4867 , 4867 , 0 , 2067 , 2067 , 0 , 135.462022254475 
05-May-2016 09:32,201603,EASTERN EUROPE-EU,POLAND,BIRMINGHAM,GDANSK, 3077 , 3077 , 0 , 5252 , 5252 , 0 ,-41.4127951256664 
05-May-2016 09:32,201603,EASTERN EUROPE-EU,POLAND,BIRMINGHAM,KATOWICE, 2765 , 2765 , 0 , 3164 , 3164 , 0 ,-12.6106194690265 
05-May-2016 09:32,201603,EASTERN EUROPE-EU,POLAND,BIRMINGHAM,KRAKOW, 3625 , 3197 , 428 , 3174 , 3174 , 0 , 14.2091997479521 
05-May-2016 09:32,201603,EASTERN EUROPE-EU,POLAND,BIRMINGHAM,POZNAN, 2349 , 2349 , 0 , 0 , 0 , 0 , 0 
05-May-2016 09:32,201603,EASTERN EUROPE-EU,POLAND,BIRMINGHAM,WARSAW (CHOPIN), 2634 , 2634 , 0 , 0 , 0 , 0 , 0 
05-May-2016 09:32,201603,EASTERN EUROPE-EU,POLAND,BIRMINGHAM,WROCLAW, 1142 , 1142 , 0 , 0 , 0 , 0 , 0 
05-May-2016 09:32,201603,EASTERN EUROPE-EU,POLAND,BRISTOL,GDANSK, 2855 , 2855 , 0 , 3198 , 3198 , 0 ,-10.7254534083802 
05-May-2016 09:32,201603,EASTERN EUROPE-EU,POLAND,BRISTOL,KATOWICE, 2891 , 2891 , 0 , 0 , 0 , 0 , 0 
05-May-2016 09:32,201603,EASTERN EUROPE-EU,POLAND,BRISTOL,KRAKOW, 8195 , 8195 , 0 , 5905 , 5905 , 0 , 38.7806943268417 
05-May-2016 09:32,201603,EASTERN EUROPE-EU,POLAND,BRISTOL,POZNAN, 3140 , 3140 , 0 , 3150 , 3150 , 0 ,-0.317460317460317 
05-May-2016 09:32,201603,EASTERN EUROPE-EU,POLAND,BRISTOL,RZESZOW, 2805 , 2805 , 0 , 354 , 354 , 0 , 692.372881355932 
05-May-2016 09:32,201603,EASTERN EUROPE-EU,POLAND,BRISTOL,WARSAW (MODLIN MASOVIA), 4938 , 4938 , 0 , 4615 , 4615 , 0 , 6.99891657638137 
05-May-2016 09:32,201603,EASTERN EUROPE-EU,POLAND,BRISTOL,WROCLAW, 3180 , 3180 , 0 , 3235 , 3235 , 0 ,-1.70015455950541 
05-May-2016 09:32,201603,EASTERN EUROPE-EU,POLAND,DONCASTER SHEFFIELD,GDANSK, 6453 , 6453 , 0 , 5092 , 5092 , 0 , 26.7282010997643 
05-May-2016 09:32,201603,EASTERN EUROPE-EU,POLAND,DONCASTER SHEFFIELD,KATOWICE, 7402 , 7402 , 0 , 5478 , 5478 , 0 , 35.122307411464 
05-May-2016 09:32,201603,EASTERN EUROPE-EU,POLAND,DONCASTER SHEFFIELD,LUBLIN (PORT LOTNICZY), 3506 , 3506 , 0 , 0 , 0 , 0 , 0 
05-May-2016 09:32,201603,EASTERN EUROPE-EU,POLAND,DONCASTER SHEFFIELD,POZNAN, 6839 , 6839 , 0 , 3885 , 3885 , 0 , 76.036036036036 
05-May-2016 09:32,201603,EASTERN EUROPE-EU,POLAND,DONCASTER SHEFFIELD,WARSAW (CHOPIN), 3780 , 3780 , 0 , 2541 , 2541 , 0 , 48.7603305785124 
05-May-2016 09:32,201603,EASTERN EUROPE-EU,POLAND,DONCASTER SHEFFIELD,WROCLAW, 4621 , 4621 , 0 , 3942 , 3942 , 0 , 17.2247590055809 
05-May-2016 09:32,201603,EASTERN EUROPE-EU,POLAND,EAST MIDLANDS INTERNATIONAL,KRAKOW, 5266 , 4833 , 433 , 5039 , 4608 , 431 , 4.50486207580869 
05-May-2016 09:32,201603,EASTERN EUROPE-EU,POLAND,EAST MIDLANDS INTERNATIONAL,LODZ LUBLINEK, 2795 , 2795 , 0 , 3130 , 3130 , 0 ,-10.702875399361 
05-May-2016 09:32,201603,EASTERN EUROPE-EU,POLAND,EAST MIDLANDS INTERNATIONAL,RZESZOW, 4908 , 4908 , 0 , 4581 , 4581 , 0 , 7.13817943680419 
05-May-2016 09:32,201603,EASTERN EUROPE-EU,POLAND,EAST MIDLANDS INTERNATIONAL,WARSAW (MODLIN MASOVIA), 4718 , 4718 , 0 , 4250 , 4250 , 0 , 11.0117647058824 
05-May-2016 09:32,201603,EASTERN EUROPE-EU,POLAND,EAST MIDLANDS INTERNATIONAL,WROCLAW, 6498 , 6498 , 0 , 6199 , 6199 , 0 , 4.82335860622681 
05-May-2016 09:32,201603,EASTERN EUROPE-EU,POLAND,EDINBURGH,GDANSK, 4646 , 4646 , 0 , 4385 , 4385 , 0 , 5.9521094640821 
05-May-2016 09:32,201603,EASTERN EUROPE-EU,POLAND,EDINBURGH,KRAKOW, 11599 , 11599 , 0 , 8860 , 8860 , 0 , 30.9142212189616 
05-May-2016 09:32,201603,EASTERN EUROPE-EU,POLAND,EDINBURGH,POZNAN, 1344 , 1344 , 0 , 330 , 330 , 0 , 307.272727272727 
05-May-2016 09:32,201603,EASTERN EUROPE-EU,POLAND,EXETER,KRAKOW, 431 , 0 , 431 , 434 , 0 , 434 ,-0.691244239631336 
05-May-2016 09:32,201603,EASTERN EUROPE-EU,POLAND,GATWICK,KRAKOW, 9393 , 9393 , 0 , 9306 , 9306 , 0 , 0.934880722114765 
05-May-2016 09:32,201603,EASTERN EUROPE-EU,POLAND,GATWICK,RZESZOW, 359 , 0 , 359 , 359 , 0 , 359 , 0 
05-May-2016 09:32,201603,EASTERN EUROPE-EU,POLAND,GATWICK,WARSAW (CHOPIN), 4749 , 4749 , 0 , 6041 , 6041 , 0 ,-21.3871875517298 
05-May-2016 09:32,201603,EASTERN EUROPE-EU,POLAND,GLASGOW,BYDGOSZCZ, 2448 , 2448 , 0 , 1325 , 1325 , 0 , 84.7547169811321 
05-May-2016 09:32,201603,EASTERN EUROPE-EU,POLAND,GLASGOW,GDANSK, 2744 , 2744 , 0 , 2518 , 2518 , 0 , 8.97537728355838 
05-May-2016 09:32,201603,EASTERN EUROPE-EU,POLAND,GLASGOW,KATOWICE, 2773 , 2773 , 0 , 3096 , 3096 , 0 ,-10.4328165374677 
05-May-2016 09:32,201603,EASTERN EUROPE-EU,POLAND,GLASGOW,LUBLIN (PORT LOTNICZY), 1509 , 1509 , 0 , 0 , 0 , 0 , 0 
05-May-2016 09:32,201603,EASTERN EUROPE-EU,POLAND,GLASGOW,POZNAN, 2502 , 2502 , 0 , 2631 , 2631 , 0 ,-4.90307867730901 
05-May-2016 09:32,201603,EASTERN EUROPE-EU,POLAND,GLASGOW,WARSAW (CHOPIN), 3274 , 3274 , 0 , 2636 , 2636 , 0 , 24.2033383915023 
05-May-2016 09:32,201603,EASTERN EUROPE-EU,POLAND,GLASGOW,WARSAW (MODLIN MASOVIA), 4869 , 4869 , 0 , 4429 , 4429 , 0 , 9.93452246556785 
05-May-2016 09:32,201603,EASTERN EUROPE-EU,POLAND,GLASGOW,WROCLAW, 2780 , 2780 , 0 , 3110 , 3110 , 0 ,-10.6109324758842 
05-May-2016 09:32,201603,EASTERN EUROPE-EU,POLAND,HEATHROW,KRAKOW, 5215 , 5215 , 0 , 0 , 0 , 0 , 0 
05-May-2016 09:32,201603,EASTERN EUROPE-EU,POLAND,HEATHROW,WARSAW (CHOPIN), 31153 , 31153 , 0 , 31920 , 31920 , 0 ,-2.40288220551378 
05-May-2016 09:32,201603,EASTERN EUROPE-EU,POLAND,LEEDS BRADFORD,GDANSK, 5436 , 5436 , 0 , 2230 , 2230 , 0 , 143.766816143498 
05-May-2016 09:32,201603,EASTERN EUROPE-EU,POLAND,LEEDS BRADFORD,KRAKOW, 5110 , 4641 , 469 , 5075 , 4617 , 458 , 0.689655172413793 
05-May-2016 09:32,201603,EASTERN EUROPE-EU,POLAND,LIVERPOOL (JOHN LENNON),GDANSK, 4597 , 4597 , 0 , 3993 , 3993 , 0 , 15.1264713248184 
05-May-2016 09:32,201603,EASTERN EUROPE-EU,POLAND,LIVERPOOL (JOHN LENNON),KATOWICE, 271 , 271 , 0 , 0 , 0 , 0 , 0 
05-May-2016 09:32,201603,EASTERN EUROPE-EU,POLAND,LIVERPOOL (JOHN LENNON),KRAKOW, 8857 , 8857 , 0 , 8719 , 8719 , 0 , 1.58275031540314 
05-May-2016 09:32,201603,EASTERN EUROPE-EU,POLAND,LIVERPOOL (JOHN LENNON),POZNAN, 3137 , 3137 , 0 , 3083 , 3083 , 0 , 1.75154070710347 
05-May-2016 09:32,201603,EASTERN EUROPE-EU,POLAND,LIVERPOOL (JOHN LENNON),SZCZECIN (GOLENOW), 650 , 650 , 0 , 323 , 323 , 0 , 101.238390092879 
05-May-2016 09:32,201603,EASTERN EUROPE-EU,POLAND,LIVERPOOL (JOHN LENNON),WARSAW (CHOPIN), 0 , 0 , 0 , 3030 , 3030 , 0 , 0 
05-May-2016 09:32,201603,EASTERN EUROPE-EU,POLAND,LIVERPOOL (JOHN LENNON),WARSAW (MODLIN MASOVIA), 8814 , 8814 , 0 , 5832 , 5832 , 0 , 51.1316872427984 
05-May-2016 09:32,201603,EASTERN EUROPE-EU,POLAND,LIVERPOOL (JOHN LENNON),WROCLAW, 4906 , 4906 , 0 , 4846 , 4846 , 0 , 1.23813454395378 
05-May-2016 09:32,201603,EASTERN EUROPE-EU,POLAND,LUTON,GDANSK, 19842 , 19842 , 0 , 18860 , 18860 , 0 , 5.2067868504772 
05-May-2016 09:32,201603,EASTERN EUROPE-EU,POLAND,LUTON,KATOWICE, 25628 , 25628 , 0 , 20221 , 20221 , 0 , 26.7395282132437 
05-May-2016 09:32,201603,EASTERN EUROPE-EU,POLAND,LUTON,KRAKOW, 0 , 0 , 0 , 436 , 0 , 436 , 0 
05-May-2016 09:32,201603,EASTERN EUROPE-EU,POLAND,LUTON,LUBLIN (PORT LOTNICZY), 7718 , 7718 , 0 , 4303 , 4303 , 0 , 79.3632349523588 
05-May-2016 09:32,201603,EASTERN EUROPE-EU,POLAND,LUTON,POZNAN, 13220 , 13220 , 0 , 8415 , 8415 , 0 , 57.1004159239453 
05-May-2016 09:32,201603,EASTERN EUROPE-EU,POLAND,LUTON,RZESZOW, 4899 , 4899 , 0 , 4539 , 4539 , 0 , 7.93126239259749 
05-May-2016 09:32,201603,EASTERN EUROPE-EU,POLAND,LUTON,SZCZECIN (GOLENOW), 4018 , 4018 , 0 , 3598 , 3598 , 0 , 11.6731517509728 
05-May-2016 09:32,201603,EASTERN EUROPE-EU,POLAND,LUTON,WARSAW (CHOPIN), 29275 , 29254 , 21 , 27549 , 27549 , 0 , 6.26520018875458 
05-May-2016 09:32,201603,EASTERN EUROPE-EU,POLAND,LUTON,WROCLAW, 9552 , 9552 , 0 , 6706 , 6706 , 0 , 42.4396063226961 
05-May-2016 09:32,201603,EASTERN EUROPE-EU,POLAND,MANCHESTER,GDANSK, 2995 , 2995 , 0 , 3001 , 3001 , 0 ,-0.199933355548151 
05-May-2016 09:32,201603,EASTERN EUROPE-EU,POLAND,MANCHESTER,KRAKOW, 4602 , 4602 , 0 , 4527 , 4527 , 0 , 1.65672630881378 
05-May-2016 09:32,201603,EASTERN EUROPE-EU,POLAND,MANCHESTER,RZESZOW, 3167 , 3167 , 0 , 3143 , 3143 , 0 , 0.763601654470251 
05-May-2016 09:32,201603,EASTERN EUROPE-EU,POLAND,MANCHESTER,WARSAW (MODLIN MASOVIA), 4776 , 4776 , 0 , 4362 , 4362 , 0 , 9.49105914718019 
05-May-2016 09:32,201603,EASTERN EUROPE-EU,POLAND,NEWCASTLE,KRAKOW, 2296 , 2296 , 0 , 2417 , 2417 , 0 ,-5.00620604054613 
05-May-2016 09:32,201603,EASTERN EUROPE-EU,POLAND,STANSTED,BYDGOSZCZ, 9114 , 9114 , 0 , 4197 , 4197 , 0 , 117.155110793424 
05-May-2016 09:32,201603,EASTERN EUROPE-EU,POLAND,STANSTED,GDANSK, 18087 , 18087 , 0 , 18667 , 18667 , 0 ,-3.10708737343976 
05-May-2016 09:32,201603,EASTERN EUROPE-EU,POLAND,STANSTED,KATOWICE, 10845 , 10845 , 0 , 11102 , 11102 , 0 ,-2.31489821653756 
05-May-2016 09:32,201603,EASTERN EUROPE-EU,POLAND,STANSTED,KRAKOW, 29058 , 29058 , 0 , 25342 , 25342 , 0 , 14.6634046247336 
05-May-2016 09:32,201603,EASTERN EUROPE-EU,POLAND,STANSTED,LODZ LUBLINEK, 8540 , 8540 , 0 , 8171 , 8171 , 0 , 4.5159711173663 
05-May-2016 09:32,201603,EASTERN EUROPE-EU,POLAND,STANSTED,LUBLIN (PORT LOTNICZY), 5604 , 5604 , 0 , 4909 , 4909 , 0 , 14.1576695864738 
05-May-2016 09:32,201603,EASTERN EUROPE-EU,POLAND,STANSTED,POZNAN, 10976 , 10976 , 0 , 10902 , 10902 , 0 , 0.678774536782242 
05-May-2016 09:32,201603,EASTERN EUROPE-EU,POLAND,STANSTED,RZESZOW, 10660 , 10660 , 0 , 8428 , 8428 , 0 , 26.4831514000949 
05-May-2016 09:32,201603,EASTERN EUROPE-EU,POLAND,STANSTED,SZCZECIN (GOLENOW), 8815 , 8815 , 0 , 4380 , 4380 , 0 , 101.255707762557 
05-May-2016 09:32,201603,EASTERN EUROPE-EU,POLAND,STANSTED,WARSAW (MODLIN MASOVIA), 35563 , 35563 , 0 , 28734 , 28734 , 0 , 23.7662699241317 
05-May-2016 09:32,201603,EASTERN EUROPE-EU,POLAND,STANSTED,WROCLAW, 18262 , 18262 , 0 , 17344 , 17344 , 0 , 5.29289667896679 
05-May-2016 09:32,201603,WESTERN EUROPE-EU,PORTUGAL(EXCLUDING MADEIRA),BELFAST CITY (GEORGE BEST),FARO, 673 , 673 , 0 , 364 , 364 , 0 , 84.8901098901099 
05-May-2016 09:32,201603,WESTERN EUROPE-EU,PORTUGAL(EXCLUDING MADEIRA),BELFAST INTERNATIONAL,FARO, 4821 , 4821 , 0 , 4088 , 4088 , 0 , 17.9305283757339 
05-May-2016 09:32,201603,WESTERN EUROPE-EU,PORTUGAL(EXCLUDING MADEIRA),BIRMINGHAM,FARO, 9298 , 9114 , 184 , 9342 , 9342 , 0 ,-0.470991222436309 
05-May-2016 09:32,201603,WESTERN EUROPE-EU,PORTUGAL(EXCLUDING MADEIRA),BIRMINGHAM,OPORTO (PORTUGAL), 0 , 0 , 0 , 1424 , 1424 , 0 , 0 
05-May-2016 09:32,201603,WESTERN EUROPE-EU,PORTUGAL(EXCLUDING MADEIRA),BOURNEMOUTH,FARO, 2257 , 2257 , 0 , 245 , 245 , 0 , 821.224489795918 
05-May-2016 09:32,201603,WESTERN EUROPE-EU,PORTUGAL(EXCLUDING MADEIRA),BRISTOL,FARO, 16541 , 16541 , 0 , 13898 , 13898 , 0 , 19.0171247661534 
05-May-2016 09:32,201603,WESTERN EUROPE-EU,PORTUGAL(EXCLUDING MADEIRA),BRISTOL,LISBON, 4883 , 4883 , 0 , 4338 , 4338 , 0 , 12.5633932687875 
05-May-2016 09:32,201603,WESTERN EUROPE-EU,PORTUGAL(EXCLUDING MADEIRA),BRISTOL,OPORTO (PORTUGAL), 3561 , 3561 , 0 , 0 , 0 , 0 , 0 
05-May-2016 09:32,201603,WESTERN EUROPE-EU,PORTUGAL(EXCLUDING MADEIRA),CARDIFF WALES,FARO, 1818 , 1818 , 0 , 0 , 0 , 0 , 0 
05-May-2016 09:32,201603,WESTERN EUROPE-EU,PORTUGAL(EXCLUDING MADEIRA),DONCASTER SHEFFIELD,FARO, 467 , 467 , 0 , 0 , 0 , 0 , 0 
05-May-2016 09:32,201603,WESTERN EUROPE-EU,PORTUGAL(EXCLUDING MADEIRA),EAST MIDLANDS INTERNATIONAL,FARO, 10325 , 10325 , 0 , 7175 , 7175 , 0 , 43.9024390243902 
05-May-2016 09:32,201603,WESTERN EUROPE-EU,PORTUGAL(EXCLUDING MADEIRA),EDINBURGH,FARO, 8041 , 8041 , 0 , 5894 , 5894 , 0 , 36.4268747879199 
05-May-2016 09:32,201603,WESTERN EUROPE-EU,PORTUGAL(EXCLUDING MADEIRA),EDINBURGH,LISBON, 4303 , 4303 , 0 , 4312 , 4312 , 0 ,-0.208719851576994 
05-May-2016 09:32,201603,WESTERN EUROPE-EU,PORTUGAL(EXCLUDING MADEIRA),EXETER,FARO, 221 , 221 , 0 , 138 , 138 , 0 , 60.1449275362319 
05-May-2016 09:32,201603,WESTERN EUROPE-EU,PORTUGAL(EXCLUDING MADEIRA),GATWICK,FARO, 43999 , 43814 , 185 , 35586 , 35366 , 220 , 23.6413196200753 
05-May-2016 09:32,201603,WESTERN EUROPE-EU,PORTUGAL(EXCLUDING MADEIRA),GATWICK,LISBON, 23065 , 23065 , 0 , 25008 , 25008 , 0 ,-7.76951375559821 
05-May-2016 09:32,201603,WESTERN EUROPE-EU,PORTUGAL(EXCLUDING MADEIRA),GATWICK,OPORTO (PORTUGAL), 22679 , 22679 , 0 , 18095 , 18095 , 0 , 25.332964907433 
05-May-2016 09:32,201603,WESTERN EUROPE-EU,PORTUGAL(EXCLUDING MADEIRA),GLASGOW,FARO, 4690 , 4690 , 0 , 2941 , 2941 , 0 , 59.4695681740904 
05-May-2016 09:32,201603,WESTERN EUROPE-EU,PORTUGAL(EXCLUDING MADEIRA),HEATHROW,FARO, 479 , 479 , 0 , 360 , 360 , 0 , 33.0555555555556 
05-May-2016 09:32,201603,WESTERN EUROPE-EU,PORTUGAL(EXCLUDING MADEIRA),HEATHROW,LISBON, 62049 , 62049 , 0 , 60195 , 60195 , 0 , 3.07999003239472 
05-May-2016 09:32,201603,WESTERN EUROPE-EU,PORTUGAL(EXCLUDING MADEIRA),LEEDS BRADFORD,FARO, 9589 , 9589 , 0 , 8522 , 8522 , 0 , 12.5205350856606 
05-May-2016 09:32,201603,WESTERN EUROPE-EU,PORTUGAL(EXCLUDING MADEIRA),LIVERPOOL (JOHN LENNON),FARO, 10791 , 10791 , 0 , 9014 , 9014 , 0 , 19.7137785666741 
05-May-2016 09:32,201603,WESTERN EUROPE-EU,PORTUGAL(EXCLUDING MADEIRA),LIVERPOOL (JOHN LENNON),LISBON, 4200 , 4200 , 0 , 2896 , 2896 , 0 , 45.0276243093923 
05-May-2016 09:32,201603,WESTERN EUROPE-EU,PORTUGAL(EXCLUDING MADEIRA),LIVERPOOL (JOHN LENNON),OPORTO (PORTUGAL), 1382 , 1382 , 0 , 304 , 304 , 0 , 354.605263157895 
05-May-2016 09:32,201603,WESTERN EUROPE-EU,PORTUGAL(EXCLUDING MADEIRA),LUTON,FARO, 10666 , 10666 , 0 , 6317 , 6317 , 0 , 68.8459711888555 
05-May-2016 09:32,201603,WESTERN EUROPE-EU,PORTUGAL(EXCLUDING MADEIRA),LUTON,LISBON, 10994 , 10994 , 0 , 9928 , 9928 , 0 , 10.737308622079 
05-May-2016 09:32,201603,WESTERN EUROPE-EU,PORTUGAL(EXCLUDING MADEIRA),LUTON,OPORTO (PORTUGAL), 3891 , 3891 , 0 , 0 , 0 , 0 , 0 
05-May-2016 09:32,201603,WESTERN EUROPE-EU,PORTUGAL(EXCLUDING MADEIRA),MANCHESTER,FARO, 26153 , 25966 , 187 , 17107 , 16918 , 189 , 52.8789384462501 
05-May-2016 09:32,201603,WESTERN EUROPE-EU,PORTUGAL(EXCLUDING MADEIRA),MANCHESTER,LISBON, 14815 , 14815 , 0 , 14149 , 14149 , 0 , 4.70704643437699 
05-May-2016 09:32,201603,WESTERN EUROPE-EU,PORTUGAL(EXCLUDING MADEIRA),MANCHESTER,OPORTO (PORTUGAL), 4698 , 4698 , 0 , 0 , 0 , 0 , 0 
05-May-2016 09:32,201603,WESTERN EUROPE-EU,PORTUGAL(EXCLUDING MADEIRA),NEWCASTLE,FARO, 4236 , 4236 , 0 , 4711 , 4711 , 0 ,-10.0827849713437 
05-May-2016 09:32,201603,WESTERN EUROPE-EU,PORTUGAL(EXCLUDING MADEIRA),PRESTWICK,FARO, 3096 , 3096 , 0 , 511 , 511 , 0 , 505.87084148728 
05-May-2016 09:32,201603,WESTERN EUROPE-EU,PORTUGAL(EXCLUDING MADEIRA),SOUTHAMPTON,FARO, 605 , 605 , 0 , 128 , 128 , 0 , 372.65625 
05-May-2016 09:32,201603,WESTERN EUROPE-EU,PORTUGAL(EXCLUDING MADEIRA),SOUTHEND,FARO, 4887 , 4887 , 0 , 4364 , 4364 , 0 , 11.9844179651696 
05-May-2016 09:32,201603,WESTERN EUROPE-EU,PORTUGAL(EXCLUDING MADEIRA),STANSTED,AZORES PONTA DELGADA, 1170 , 1170 , 0 , 0 , 0 , 0 , 0 
05-May-2016 09:32,201603,WESTERN EUROPE-EU,PORTUGAL(EXCLUDING MADEIRA),STANSTED,FARO, 13999 , 13730 , 269 , 7221 , 7032 , 189 , 93.8651156349536 
05-May-2016 09:32,201603,WESTERN EUROPE-EU,PORTUGAL(EXCLUDING MADEIRA),STANSTED,LISBON, 31777 , 31777 , 0 , 32566 , 32566 , 0 ,-2.42277221642204 
05-May-2016 09:32,201603,WESTERN EUROPE-EU,PORTUGAL(EXCLUDING MADEIRA),STANSTED,OPORTO (PORTUGAL), 24571 , 24571 , 0 , 22286 , 22286 , 0 , 10.2530736785426 
05-May-2016 09:32,201603,WESTERN EUROPE-EU,PORTUGAL(MADEIRA),BIRMINGHAM,FUNCHAL, 3838 , 2367 , 1471 , 4648 , 2947 , 1701 ,-17.4268502581756 
05-May-2016 09:32,201603,WESTERN EUROPE-EU,PORTUGAL(MADEIRA),BRISTOL,FUNCHAL, 3987 , 3987 , 0 , 4062 , 4062 , 0 ,-1.84638109305761 
05-May-2016 09:32,201603,WESTERN EUROPE-EU,PORTUGAL(MADEIRA),EAST MIDLANDS INTERNATIONAL,FUNCHAL, 2838 , 1417 , 1421 , 3350 , 1619 , 1731 ,-15.2835820895522 
05-May-2016 09:32,201603,WESTERN EUROPE-EU,PORTUGAL(MADEIRA),EDINBURGH,FUNCHAL, 3170 , 3170 , 0 , 2350 , 2350 , 0 , 34.8936170212766 
05-May-2016 09:32,201603,WESTERN EUROPE-EU,PORTUGAL(MADEIRA),GATWICK,FUNCHAL, 25038 , 21479 , 3559 , 17133 , 15032 , 2101 , 46.1390299422168 
05-May-2016 09:32,201603,WESTERN EUROPE-EU,PORTUGAL(MADEIRA),GLASGOW,FUNCHAL, 3020 , 1425 , 1595 , 3445 , 1629 , 1816 ,-12.3367198838897 
05-May-2016 09:32,201603,WESTERN EUROPE-EU,PORTUGAL(MADEIRA),HEATHROW,FUNCHAL, 0 , 0 , 0 , 3145 , 3145 , 0 , 0 
05-May-2016 09:32,201603,WESTERN EUROPE-EU,PORTUGAL(MADEIRA),JERSEY,FUNCHAL, 278 , 278 , 0 , 754 , 0 , 754 ,-63.1299734748011 
05-May-2016 09:32,201603,WESTERN EUROPE-EU,PORTUGAL(MADEIRA),LEEDS BRADFORD,FUNCHAL, 1421 , 1421 , 0 , 1746 , 1746 , 0 ,-18.6139747995418 
05-May-2016 09:32,201603,WESTERN EUROPE-EU,PORTUGAL(MADEIRA),LUTON,FUNCHAL, 1192 , 0 , 1192 , 0 , 0 , 0 , 0 
05-May-2016 09:32,201603,WESTERN EUROPE-EU,PORTUGAL(MADEIRA),MANCHESTER,FUNCHAL, 7180 , 3889 , 3291 , 6351 , 4556 , 1795 , 13.053062509841 
05-May-2016 09:32,201603,WESTERN EUROPE-EU,PORTUGAL(MADEIRA),NEWCASTLE,FUNCHAL, 148 , 148 , 0 , 0 , 0 , 0 , 0 
05-May-2016 09:32,201603,CARIBBEAN AREA,PUERTO RICO,GATWICK,SAN JUAN (PUERTO RICO), 4714 , 4714 , 0 , 0 , 0 , 0 , 0 
05-May-2016 09:32,201603,MIDDLE EAST,QATAR,BIRMINGHAM,DOHA HAMAD, 682 , 682 , 0 , 208 , 208 , 0 , 227.884615384615 
05-May-2016 09:32,201603,MIDDLE EAST,QATAR,EDINBURGH,DOHA HAMAD, 10712 , 10712 , 0 , 7453 , 7453 , 0 , 43.7273581108279 
05-May-2016 09:32,201603,MIDDLE EAST,QATAR,HEATHROW,DOHA HAMAD, 100612 , 100612 , 0 , 82863 , 82863 , 0 , 21.4196927458576 
05-May-2016 09:32,201603,MIDDLE EAST,QATAR,MANCHESTER,DOHA HAMAD, 28072 , 28072 , 0 , 25092 , 25092 , 0 , 11.8762952335406 
05-May-2016 09:32,201603,FAR EAST,REPUBLIC OF KOREA,HEATHROW,SEOUL (INCHEON), 32566 , 32566 , 0 , 36368 , 36368 , 0 ,-10.4542454905411 
05-May-2016 09:32,201603,EASTERN EUROPE -OTHER,REPUBLIC OF MOLDOVA,LUTON,CHISINAU (KISHINEV), 4454 , 4454 , 0 , 0 , 0 , 0 , 0 
05-May-2016 09:32,201603,EASTERN EUROPE -OTHER,REPUBLIC OF MOLDOVA,STANSTED,CHISINAU (KISHINEV), 2669 , 2669 , 0 , 1606 , 1606 , 0 , 66.1892901618929 
05-May-2016 09:32,201603,WESTERN EUROPE-OTHER,REPUBLIC OF MONTENEGRO,MANCHESTER,TIVAT, 307 , 307 , 0 , 0 , 0 , 0 , 0 
05-May-2016 09:32,201603,WESTERN EUROPE-OTHER,REPUBLIC OF MONTENEGRO,STANSTED,PODGORICA, 3147 , 3147 , 0 , 3060 , 3060 , 0 , 2.84313725490196 
05-May-2016 09:32,201603,WESTERN EUROPE-OTHER,REPUBLIC OF SERBIA,HEATHROW,BELGRADE, 6429 , 6429 , 0 , 5325 , 5325 , 0 , 20.7323943661972 
05-May-2016 09:32,201603,WESTERN EUROPE-OTHER,REPUBLIC OF SERBIA,LUTON,BELGRADE, 3378 , 3378 , 0 , 2743 , 2743 , 0 , 23.1498359460445 
05-May-2016 09:32,201603,WESTERN EUROPE-OTHER,REPUBLIC OF SERBIA,MANCHESTER,TIVAT, 87 , 87 , 0 , 0 , 0 , 0 , 0 
05-May-2016 09:32,201603,SOUTHERN AFRICA,REPUBLIC OF SOUTH AFRICA,GLASGOW,JOHANNESBURG, 5 , 0 , 5 , 0 , 0 , 0 , 0 
05-May-2016 09:32,201603,SOUTHERN AFRICA,REPUBLIC OF SOUTH AFRICA,HEATHROW,CAPE TOWN, 36938 , 36938 , 0 , 55813 , 55813 , 0 ,-33.8182860623869 
05-May-2016 09:32,201603,SOUTHERN AFRICA,REPUBLIC OF SOUTH AFRICA,HEATHROW,JOHANNESBURG, 84213 , 84213 , 0 , 79618 , 79618 , 0 , 5.77130799567937 
05-May-2016 09:32,201603,EASTERN EUROPE-EU,ROMANIA,BIRMINGHAM,BUCHAREST (OTOPENI), 347 , 347 , 0 , 0 , 0 , 0 , 0 
05-May-2016 09:32,201603,EASTERN EUROPE-EU,ROMANIA,DONCASTER SHEFFIELD,BUCHAREST (OTOPENI), 3074 , 3074 , 0 , 2730 , 2730 , 0 , 12.6007326007326 
05-May-2016 09:32,201603,EASTERN EUROPE-EU,ROMANIA,GATWICK,BUCHAREST (OTOPENI), 0 , 0 , 0 , 4489 , 4489 , 0 , 0 
05-May-2016 09:32,201603,EASTERN EUROPE-EU,ROMANIA,GLASGOW,BUCHAREST (OTOPENI), 4873 , 4873 , 0 , 0 , 0 , 0 , 0 
05-May-2016 09:32,201603,EASTERN EUROPE-EU,ROMANIA,HEATHROW,BUCHAREST (OTOPENI), 20297 , 20297 , 0 , 18161 , 18161 , 0 , 11.7614668795771 
05-May-2016 09:32,201603,EASTERN EUROPE-EU,ROMANIA,LIVERPOOL (JOHN LENNON),BACAU, 230 , 230 , 0 , 155 , 155 , 0 , 48.3870967741936 
05-May-2016 09:32,201603,EASTERN EUROPE-EU,ROMANIA,LIVERPOOL (JOHN LENNON),BUCHAREST (OTOPENI), 4173 , 4173 , 0 , 3021 , 3021 , 0 , 38.1330685203575 
05-May-2016 09:32,201603,EASTERN EUROPE-EU,ROMANIA,LUTON,BACAU, 5310 , 5310 , 0 , 5022 , 5022 , 0 , 5.73476702508961 
05-May-2016 09:32,201603,EASTERN EUROPE-EU,ROMANIA,LUTON,BUCHAREST (OTOPENI), 38030 , 38030 , 0 , 31242 , 31242 , 0 , 21.7271621535113 
05-May-2016 09:32,201603,EASTERN EUROPE-EU,ROMANIA,LUTON,CLUJ NAPOCA, 18548 , 18548 , 0 , 13216 , 13216 , 0 , 40.3450363196126 
05-May-2016 09:32,201603,EASTERN EUROPE-EU,ROMANIA,LUTON,CONSTANTA, 2562 , 2562 , 0 , 0 , 0 , 0 , 0 
05-May-2016 09:32,201603,EASTERN EUROPE-EU,ROMANIA,LUTON,CRAIOVA, 5738 , 5738 , 0 , 3820 , 3820 , 0 , 50.2094240837696 
05-May-2016 09:32,201603,EASTERN EUROPE-EU,ROMANIA,LUTON,IASI, 7917 , 7917 , 0 , 1470 , 1470 , 0 , 438.571428571429 
05-May-2016 09:32,201603,EASTERN EUROPE-EU,ROMANIA,LUTON,SIBIU, 4308 , 4308 , 0 , 2592 , 2592 , 0 , 66.2037037037037 
05-May-2016 09:32,201603,EASTERN EUROPE-EU,ROMANIA,LUTON,TIMISOARA, 8668 , 8668 , 0 , 5498 , 5498 , 0 , 57.6573299381593 
05-May-2016 09:32,201603,EASTERN EUROPE-EU,ROMANIA,LUTON,TIRGU MURES, 6475 , 6475 , 0 , 5026 , 5026 , 0 , 28.8300835654596 
05-May-2016 09:32,201603,EASTERN EUROPE-EU,ROMANIA,STANSTED,BUCHAREST (OTOPENI), 22326 , 22326 , 0 , 20839 , 20839 , 0 , 7.1356591007246 
05-May-2016 09:32,201603,EASTERN EUROPE -OTHER,RUSSIA,BIGGIN HILL,MOSCOW (SHEREMETYEVO), 0 , 0 , 0 , 10 , 0 , 10 , 0 
05-May-2016 09:32,201603,EASTERN EUROPE -OTHER,RUSSIA,GATWICK,MOSCOW (DOMODEDOVO), 5325 , 5325 , 0 , 13427 , 13427 , 0 ,-60.3411037461831 
05-May-2016 09:32,201603,EASTERN EUROPE -OTHER,RUSSIA,HEATHROW,MOSCOW (DOMODEDOVO), 18427 , 18427 , 0 , 17529 , 17529 , 0 , 5.12293912944264 
05-May-2016 09:32,201603,EASTERN EUROPE -OTHER,RUSSIA,HEATHROW,MOSCOW (SHEREMETYEVO), 22647 , 22647 , 0 , 19998 , 19998 , 0 , 13.2463246324632 
05-May-2016 09:32,201603,EASTERN EUROPE -OTHER,RUSSIA,HEATHROW,MOSCOW (VNUKOVO), 14 , 14 , 0 , 8970 , 8970 , 0 ,-99.8439241917503 
05-May-2016 09:32,201603,EASTERN EUROPE -OTHER,RUSSIA,HEATHROW,ST PETERSBURG, 6377 , 6377 , 0 , 5102 , 5102 , 0 , 24.9901999215994 
05-May-2016 09:32,201603,EASTERN EUROPE -OTHER,RUSSIA,LUTON,MOSCOW (VNUKOVO), 7 , 0 , 7 , 0 , 0 , 0 , 0 
05-May-2016 09:32,201603,EASTERN EUROPE -OTHER,RUSSIA,MANCHESTER,MOSCOW (DOMODEDOVO), 0 , 0 , 0 , 2225 , 2225 , 0 , 0 
05-May-2016 09:32,201603,CARIBBEAN AREA,SAINT KITTS AND NEVIS,GATWICK,ST KITTS, 4530 , 4530 , 0 , 4232 , 4232 , 0 , 7.04158790170132 
05-May-2016 09:32,201603,MIDDLE EAST,SAUDI ARABIA,HEATHROW,JEDDAH, 22235 , 22235 , 0 , 18740 , 18740 , 0 , 18.649946638207 
05-May-2016 09:32,201603,MIDDLE EAST,SAUDI ARABIA,HEATHROW,RIYADH, 21825 , 21825 , 0 , 20466 , 20466 , 0 , 6.64028144239226 
05-May-2016 09:32,201603,MIDDLE EAST,SAUDI ARABIA,LUTON,DHAHRAN, 4 , 0 , 4 , 0 , 0 , 0 , 0 
05-May-2016 09:32,201603,MIDDLE EAST,SAUDI ARABIA,LUTON,RIYADH, 5 , 0 , 5 , 0 , 0 , 0 , 0 
05-May-2016 09:32,201603,MIDDLE EAST,SAUDI ARABIA,MANCHESTER,JEDDAH, 8246 , 8246 , 0 , 7065 , 7065 , 0 , 16.7162066525124 
05-May-2016 09:32,201603,FAR EAST,SINGAPORE,HEATHROW,SINGAPORE, 96017 , 96017 , 0 , 91265 , 91265 , 0 , 5.20681531802991 
05-May-2016 09:32,201603,FAR EAST,SINGAPORE,MANCHESTER,SINGAPORE, 9605 , 9605 , 0 , 8288 , 8288 , 0 , 15.890444015444 
05-May-2016 09:32,201603,EASTERN EUROPE-EU,SLOVAK REPUBLIC,BIRMINGHAM,BRATISLAVA, 4691 , 4691 , 0 , 4492 , 4492 , 0 , 4.43009795191452 
05-May-2016 09:32,201603,EASTERN EUROPE-EU,SLOVAK REPUBLIC,BRISTOL,KOSICE, 1763 , 1763 , 0 , 0 , 0 , 0 , 0 
05-May-2016 09:32,201603,EASTERN EUROPE-EU,SLOVAK REPUBLIC,DONCASTER SHEFFIELD,KOSICE, 2996 , 2996 , 0 , 0 , 0 , 0 , 0 
05-May-2016 09:32,201603,EASTERN EUROPE-EU,SLOVAK REPUBLIC,EDINBURGH,BRATISLAVA, 1357 , 1357 , 0 , 352 , 352 , 0 , 285.511363636364 
05-May-2016 09:32,201603,EASTERN EUROPE-EU,SLOVAK REPUBLIC,LIVERPOOL (JOHN LENNON),BRATISLAVA, 4009 , 4009 , 0 , 4539 , 4539 , 0 ,-11.6765807446574 
05-May-2016 09:32,201603,EASTERN EUROPE-EU,SLOVAK REPUBLIC,LUTON,BRATISLAVA, 5103 , 5103 , 0 , 5523 , 5523 , 0 ,-7.60456273764259 
05-May-2016 09:32,201603,EASTERN EUROPE-EU,SLOVAK REPUBLIC,LUTON,KOSICE, 10661 , 10661 , 0 , 9542 , 9542 , 0 , 11.727101236638 
05-May-2016 09:32,201603,EASTERN EUROPE-EU,SLOVAK REPUBLIC,LUTON,TATRY-POPRAD, 5105 , 5105 , 0 , 5139 , 5139 , 0 ,-0.66160731659856 
05-May-2016 09:32,201603,EASTERN EUROPE-EU,SLOVAK REPUBLIC,STANSTED,BRATISLAVA, 20089 , 20089 , 0 , 20323 , 20323 , 0 ,-1.15140481228165 
05-May-2016 09:32,201603,WESTERN EUROPE-EU,SLOVENIA,BELFAST INTERNATIONAL,LJUBLJANA, 113 , 0 , 113 , 0 , 0 , 0 , 0 
05-May-2016 09:32,201603,WESTERN EUROPE-EU,SLOVENIA,LUTON,LJUBLJANA, 5182 , 5182 , 0 , 3634 , 3634 , 0 , 42.5976884975234 
05-May-2016 09:32,201603,WESTERN EUROPE-EU,SLOVENIA,STANSTED,LJUBLJANA, 7477 , 7477 , 0 , 6806 , 6806 , 0 , 9.85894798707023 
05-May-2016 09:32,201603,WESTERN EUROPE-EU,SPAIN,BELFAST CITY (GEORGE BEST),MALAGA, 745 , 745 , 0 , 416 , 416 , 0 , 79.0865384615385 
05-May-2016 09:32,201603,WESTERN EUROPE-EU,SPAIN,BELFAST INTERNATIONAL,ALICANTE, 7294 , 7294 , 0 , 4312 , 4312 , 0 , 69.1558441558442 
05-May-2016 09:32,201603,WESTERN EUROPE-EU,SPAIN,BELFAST INTERNATIONAL,BARCELONA, 475 , 475 , 0 , 2628 , 2628 , 0 ,-81.9254185692542 
05-May-2016 09:32,201603,WESTERN EUROPE-EU,SPAIN,BELFAST INTERNATIONAL,MALAGA, 5536 , 5536 , 0 , 5770 , 5770 , 0 ,-4.05545927209705 
05-May-2016 09:32,201603,WESTERN EUROPE-EU,SPAIN,BELFAST INTERNATIONAL,PALMA DE MALLORCA, 1521 , 1521 , 0 , 0 , 0 , 0 , 0 
05-May-2016 09:32,201603,WESTERN EUROPE-EU,SPAIN,BIRMINGHAM,ALICANTE, 25208 , 22926 , 2282 , 17654 , 15799 , 1855 , 42.7891695932933 
05-May-2016 09:32,201603,WESTERN EUROPE-EU,SPAIN,BIRMINGHAM,BARCELONA, 19425 , 19425 , 0 , 5868 , 5868 , 0 , 231.032719836401 
05-May-2016 09:32,201603,WESTERN EUROPE-EU,SPAIN,BIRMINGHAM,IBIZA, 479 , 479 , 0 , 0 , 0 , 0 , 0 
05-May-2016 09:32,201603,WESTERN EUROPE-EU,SPAIN,BIRMINGHAM,LIEIDA, 693 , 0 , 693 , 858 , 0 , 858 ,-19.2307692307692 
05-May-2016 09:32,201603,WESTERN EUROPE-EU,SPAIN,BIRMINGHAM,MADRID, 3957 , 3957 , 0 , 555 , 555 , 0 , 612.972972972973 
05-May-2016 09:32,201603,WESTERN EUROPE-EU,SPAIN,BIRMINGHAM,MAHON, 0 , 0 , 0 , 225 , 225 , 0 , 0 
05-May-2016 09:32,201603,WESTERN EUROPE-EU,SPAIN,BIRMINGHAM,MALAGA, 22069 , 20557 , 1512 , 14521 , 12688 , 1833 , 51.9798911920667 
05-May-2016 09:32,201603,WESTERN EUROPE-EU,SPAIN,BIRMINGHAM,MURCIA SAN JAVIER, 2557 , 2557 , 0 , 479 , 479 , 0 , 433.820459290188 
05-May-2016 09:32,201603,WESTERN EUROPE-EU,SPAIN,BIRMINGHAM,PALMA DE MALLORCA, 8524 , 6122 , 2402 , 3493 , 1196 , 2297 , 144.030918980819 
05-May-2016 09:32,201603,WESTERN EUROPE-EU,SPAIN,BIRMINGHAM,SEVILLE, 0 , 0 , 0 , 233 , 0 , 233 , 0 
05-May-2016 09:32,201603,WESTERN EUROPE-EU,SPAIN,BOURNEMOUTH,ALICANTE, 4410 , 4410 , 0 , 3358 , 3358 , 0 , 31.328171530673 
05-May-2016 09:32,201603,WESTERN EUROPE-EU,SPAIN,BOURNEMOUTH,GIRONA, 1958 , 1958 , 0 , 278 , 278 , 0 , 604.31654676259 
05-May-2016 09:32,201603,WESTERN EUROPE-EU,SPAIN,BOURNEMOUTH,MALAGA, 4916 , 4916 , 0 , 3127 , 3127 , 0 , 57.2113847137832 
05-May-2016 09:32,201603,WESTERN EUROPE-EU,SPAIN,BOURNEMOUTH,MURCIA SAN JAVIER, 0 , 0 , 0 , 477 , 477 , 0 , 0 
05-May-2016 09:32,201603,WESTERN EUROPE-EU,SPAIN,BOURNEMOUTH,PALMA DE MALLORCA, 2503 , 2314 , 189 , 396 , 396 , 0 , 532.070707070707 
05-May-2016 09:32,201603,WESTERN EUROPE-EU,SPAIN,BRISTOL,ALICANTE, 21031 , 19077 , 1954 , 16702 , 14964 , 1738 , 25.9190516105856 
05-May-2016 09:32,201603,WESTERN EUROPE-EU,SPAIN,BRISTOL,BARCELONA, 9531 , 9531 , 0 , 9681 , 9681 , 0 ,-1.54942671211652 
05-May-2016 09:32,201603,WESTERN EUROPE-EU,SPAIN,BRISTOL,GIRONA, 2639 , 2639 , 0 , 547 , 547 , 0 , 382.449725776965 
05-May-2016 09:32,201603,WESTERN EUROPE-EU,SPAIN,BRISTOL,LIEIDA, 0 , 0 , 0 , 770 , 0 , 770 , 0 
05-May-2016 09:32,201603,WESTERN EUROPE-EU,SPAIN,BRISTOL,MADRID, 7783 , 7783 , 0 , 7492 , 7492 , 0 , 3.88414308595836 
05-May-2016 09:32,201603,WESTERN EUROPE-EU,SPAIN,BRISTOL,MALAGA, 20301 , 18768 , 1533 , 17363 , 17142 , 221 , 16.9210389909578 
05-May-2016 09:32,201603,WESTERN EUROPE-EU,SPAIN,BRISTOL,MURCIA SAN JAVIER, 3134 , 3134 , 0 , 2536 , 2536 , 0 , 23.5804416403785 
05-May-2016 09:32,201603,WESTERN EUROPE-EU,SPAIN,BRISTOL,PALMA DE MALLORCA, 10074 , 10074 , 0 , 5110 , 4889 , 221 , 97.1428571428571 
05-May-2016 09:32,201603,WESTERN EUROPE-EU,SPAIN,BRISTOL,VALENCIA, 0 , 0 , 0 , 303 , 303 , 0 , 0 
05-May-2016 09:32,201603,WESTERN EUROPE-EU,SPAIN,CARDIFF WALES,ALICANTE, 7200 , 3915 , 3285 , 6068 , 2803 , 3265 , 18.6552406064601 
05-May-2016 09:32,201603,WESTERN EUROPE-EU,SPAIN,CARDIFF WALES,BARCELONA, 589 , 589 , 0 , 0 , 0 , 0 , 0 
05-May-2016 09:32,201603,WESTERN EUROPE-EU,SPAIN,CARDIFF WALES,MALAGA, 5484 , 3518 , 1966 , 4428 , 2620 , 1808 , 23.8482384823848 
05-May-2016 09:32,201603,WESTERN EUROPE-EU,SPAIN,CARDIFF WALES,PALMA DE MALLORCA, 501 , 501 , 0 , 0 , 0 , 0 , 0 
05-May-2016 09:32,201603,WESTERN EUROPE-EU,SPAIN,DONCASTER SHEFFIELD,ALICANTE, 5702 , 516 , 5186 , 3304 , 0 , 3304 , 72.5786924939467 
05-May-2016 09:32,201603,WESTERN EUROPE-EU,SPAIN,DONCASTER SHEFFIELD,MALAGA, 3867 , 459 , 3408 , 3164 , 0 , 3164 , 22.2187104930468 
05-May-2016 09:32,201603,WESTERN EUROPE-EU,SPAIN,DONCASTER SHEFFIELD,PALMA DE MALLORCA, 1316 , 0 , 1316 , 1484 , 0 , 1484 ,-11.3207547169811 
05-May-2016 09:32,201603,WESTERN EUROPE-EU,SPAIN,EAST MIDLANDS INTERNATIONAL,ALICANTE, 25125 , 23073 , 2052 , 23282 , 21235 , 2047 , 7.91598659908943 
05-May-2016 09:32,201603,WESTERN EUROPE-EU,SPAIN,EAST MIDLANDS INTERNATIONAL,BARCELONA, 4212 , 4212 , 0 , 832 , 832 , 0 , 406.25 
05-May-2016 09:32,201603,WESTERN EUROPE-EU,SPAIN,EAST MIDLANDS INTERNATIONAL,IBIZA, 0 , 0 , 0 , 182 , 182 , 0 , 0 
05-May-2016 09:32,201603,WESTERN EUROPE-EU,SPAIN,EAST MIDLANDS INTERNATIONAL,MAHON, 0 , 0 , 0 , 186 , 186 , 0 , 0 
05-May-2016 09:32,201603,WESTERN EUROPE-EU,SPAIN,EAST MIDLANDS INTERNATIONAL,MALAGA, 17837 , 14902 , 2935 , 16485 , 14663 , 1822 , 8.20139520776464 
05-May-2016 09:32,201603,WESTERN EUROPE-EU,SPAIN,EAST MIDLANDS INTERNATIONAL,MURCIA SAN JAVIER, 4355 , 4355 , 0 , 733 , 733 , 0 , 494.133697135061 
05-May-2016 09:32,201603,WESTERN EUROPE-EU,SPAIN,EAST MIDLANDS INTERNATIONAL,PALMA DE MALLORCA, 8667 , 7844 , 823 , 1548 , 1366 , 182 , 459.883720930233 
05-May-2016 09:32,201603,WESTERN EUROPE-EU,SPAIN,EAST MIDLANDS INTERNATIONAL,VALENCIA, 2248 , 2248 , 0 , 274 , 274 , 0 , 720.43795620438 
05-May-2016 09:32,201603,WESTERN EUROPE-EU,SPAIN,EDINBURGH,ALICANTE, 12593 , 12593 , 0 , 8988 , 8988 , 0 , 40.1090342679128 
05-May-2016 09:32,201603,WESTERN EUROPE-EU,SPAIN,EDINBURGH,BARCELONA, 11260 , 11260 , 0 , 5559 , 5380 , 179 , 102.554416261918 
05-May-2016 09:32,201603,WESTERN EUROPE-EU,SPAIN,EDINBURGH,BILBAO, 324 , 0 , 324 , 0 , 0 , 0 , 0 
05-May-2016 09:32,201603,WESTERN EUROPE-EU,SPAIN,EDINBURGH,MADRID, 15453 , 15453 , 0 , 10405 , 10405 , 0 , 48.5151369533878 
05-May-2016 09:32,201603,WESTERN EUROPE-EU,SPAIN,EDINBURGH,MALAGA, 12518 , 12518 , 0 , 6247 , 6247 , 0 , 100.384184408516 
05-May-2016 09:32,201603,WESTERN EUROPE-EU,SPAIN,EDINBURGH,PALMA DE MALLORCA, 5543 , 5543 , 0 , 1105 , 917 , 188 , 401.628959276018 
05-May-2016 09:32,201603,WESTERN EUROPE-EU,SPAIN,EDINBURGH,SANTANDER, 3039 , 3039 , 0 , 334 , 334 , 0 , 809.880239520958 
05-May-2016 09:32,201603,WESTERN EUROPE-EU,SPAIN,EXETER,ALICANTE, 518 , 518 , 0 , 323 , 323 , 0 , 60.3715170278638 
05-May-2016 09:32,201603,WESTERN EUROPE-EU,SPAIN,EXETER,MALAGA, 662 , 662 , 0 , 333 , 333 , 0 , 98.7987987987988 
05-May-2016 09:32,201603,WESTERN EUROPE-EU,SPAIN,EXETER,PALMA DE MALLORCA, 373 , 187 , 186 , 374 , 0 , 374 ,-0.267379679144385 
05-May-2016 09:32,201603,WESTERN EUROPE-EU,SPAIN,GATWICK,A CORUNA, 460 , 460 , 0 , 0 , 0 , 0 , 0 
05-May-2016 09:32,201603,WESTERN EUROPE-EU,SPAIN,GATWICK,ALICANTE, 50477 , 48412 , 2065 , 45206 , 43160 , 2046 , 11.6599566429235 
05-May-2016 09:32,201603,WESTERN EUROPE-EU,SPAIN,GATWICK,ALMERIA, 7562 , 7562 , 0 , 4488 , 4488 , 0 , 68.49376114082 
05-May-2016 09:32,201603,WESTERN EUROPE-EU,SPAIN,GATWICK,BARCELONA, 109427 , 109427 , 0 , 110863 , 110863 , 0 ,-1.29529238790219 
05-May-2016 09:32,201603,WESTERN EUROPE-EU,SPAIN,GATWICK,BILBAO, 8782 , 8378 , 404 , 807 , 807 , 0 , 988.22800495663 
05-May-2016 09:32,201603,WESTERN EUROPE-EU,SPAIN,GATWICK,LIEIDA, 3159 , 0 , 3159 , 2159 , 0 , 2159 , 46.3177396943029 
05-May-2016 09:32,201603,WESTERN EUROPE-EU,SPAIN,GATWICK,MADRID, 83469 , 83469 , 0 , 68536 , 68536 , 0 , 21.7885490836932 
05-May-2016 09:32,201603,WESTERN EUROPE-EU,SPAIN,GATWICK,MAHON, 2292 , 2292 , 0 , 548 , 548 , 0 , 318.248175182482 
05-May-2016 09:32,201603,WESTERN EUROPE-EU,SPAIN,GATWICK,MALAGA, 71824 , 70162 , 1662 , 64686 , 62806 , 1880 , 11.0348452524503 
05-May-2016 09:32,201603,WESTERN EUROPE-EU,SPAIN,GATWICK,MURCIA SAN JAVIER, 10646 , 10646 , 0 , 9370 , 9370 , 0 , 13.6179295624333 
05-May-2016 09:32,201603,WESTERN EUROPE-EU,SPAIN,GATWICK,PALMA DE MALLORCA, 26869 , 23977 , 2892 , 18517 , 15310 , 3207 , 45.1044985688826 
05-May-2016 09:32,201603,WESTERN EUROPE-EU,SPAIN,GATWICK,SANTIAGO DE COMPOSTELA (SPAIN), 991 , 991 , 0 , 2563 , 2563 , 0 ,-61.3343737807257 
05-May-2016 09:32,201603,WESTERN EUROPE-EU,SPAIN,GATWICK,SEVILLE, 21345 , 21345 , 0 , 13293 , 13105 , 188 , 60.5732340329497 
05-May-2016 09:32,201603,WESTERN EUROPE-EU,SPAIN,GATWICK,VALENCIA, 25014 , 25014 , 0 , 19413 , 19413 , 0 , 28.8518003399784 
05-May-2016 09:32,201603,WESTERN EUROPE-EU,SPAIN,GLASGOW,ALICANTE, 11857 , 9699 , 2158 , 11374 , 9208 , 2166 , 4.24652716722349 
05-May-2016 09:32,201603,WESTERN EUROPE-EU,SPAIN,GLASGOW,BARCELONA, 3136 , 3136 , 0 , 3096 , 3096 , 0 , 1.29198966408269 
05-May-2016 09:32,201603,WESTERN EUROPE-EU,SPAIN,GLASGOW,MALAGA, 7601 , 6127 , 1474 , 6745 , 6529 , 216 , 12.6908821349148 
05-May-2016 09:32,201603,WESTERN EUROPE-EU,SPAIN,GLASGOW,PALMA DE MALLORCA, 1339 , 732 , 607 , 2047 , 1614 , 433 ,-34.5872007816317 
05-May-2016 09:32,201603,WESTERN EUROPE-EU,SPAIN,HEATHROW,A CORUNA, 9424 , 9424 , 0 , 9030 , 9030 , 0 , 4.36323366555925 
05-May-2016 09:32,201603,WESTERN EUROPE-EU,SPAIN,HEATHROW,BARCELONA, 62162 , 62162 , 0 , 52085 , 52085 , 0 , 19.3472208889316 
05-May-2016 09:32,201603,WESTERN EUROPE-EU,SPAIN,HEATHROW,BILBAO, 15941 , 15941 , 0 , 9884 , 9884 , 0 , 61.2808579522461 
05-May-2016 09:32,201603,WESTERN EUROPE-EU,SPAIN,HEATHROW,IBIZA, 1111 , 1111 , 0 , 664 , 664 , 0 , 67.3192771084337 
05-May-2016 09:32,201603,WESTERN EUROPE-EU,SPAIN,HEATHROW,MADRID, 112620 , 112620 , 0 , 119845 , 119845 , 0 ,-6.02862030122241 
05-May-2016 09:32,201603,WESTERN EUROPE-EU,SPAIN,HEATHROW,MALAGA, 542 , 542 , 0 , 529 , 529 , 0 , 2.45746691871456 
05-May-2016 09:32,201603,WESTERN EUROPE-EU,SPAIN,HEATHROW,PALMA DE MALLORCA, 6345 , 6345 , 0 , 993 , 993 , 0 , 538.972809667674 
05-May-2016 09:32,201603,WESTERN EUROPE-EU,SPAIN,LEEDS BRADFORD,ALICANTE, 21041 , 21041 , 0 , 16653 , 16653 , 0 , 26.3496066774755 
05-May-2016 09:32,201603,WESTERN EUROPE-EU,SPAIN,LEEDS BRADFORD,BARCELONA, 6395 , 6395 , 0 , 4714 , 4714 , 0 , 35.6597369537548 
05-May-2016 09:32,201603,WESTERN EUROPE-EU,SPAIN,LEEDS BRADFORD,MAHON, 0 , 0 , 0 , 144 , 144 , 0 , 0 
05-May-2016 09:32,201603,WESTERN EUROPE-EU,SPAIN,LEEDS BRADFORD,MALAGA, 14135 , 14135 , 0 , 9508 , 9508 , 0 , 48.6642827092974 
05-May-2016 09:32,201603,WESTERN EUROPE-EU,SPAIN,LEEDS BRADFORD,MURCIA SAN JAVIER, 1563 , 1563 , 0 , 746 , 746 , 0 , 109.517426273458 
05-May-2016 09:32,201603,WESTERN EUROPE-EU,SPAIN,LEEDS BRADFORD,PALMA DE MALLORCA, 7302 , 7302 , 0 , 958 , 958 , 0 , 662.212943632568 
05-May-2016 09:32,201603,WESTERN EUROPE-EU,SPAIN,LIVERPOOL (JOHN LENNON),ALICANTE, 17139 , 17139 , 0 , 14516 , 14516 , 0 , 18.0697161752549 
05-May-2016 09:32,201603,WESTERN EUROPE-EU,SPAIN,LIVERPOOL (JOHN LENNON),BARCELONA, 18051 , 18051 , 0 , 15926 , 15926 , 0 , 13.3429611955293 
05-May-2016 09:32,201603,WESTERN EUROPE-EU,SPAIN,LIVERPOOL (JOHN LENNON),MADRID, 8511 , 8511 , 0 , 9616 , 9616 , 0 ,-11.4912645590682 
05-May-2016 09:32,201603,WESTERN EUROPE-EU,SPAIN,LIVERPOOL (JOHN LENNON),MALAGA, 15972 , 15972 , 0 , 11922 , 11922 , 0 , 33.9708102667338 
05-May-2016 09:32,201603,WESTERN EUROPE-EU,SPAIN,LIVERPOOL (JOHN LENNON),PALMA DE MALLORCA, 4835 , 4835 , 0 , 3465 , 3465 , 0 , 39.5382395382395 
05-May-2016 09:32,201603,WESTERN EUROPE-EU,SPAIN,LONDON CITY,GRANADA, 1218 , 1218 , 0 , 1649 , 1649 , 0 ,-26.137052759248 
05-May-2016 09:32,201603,WESTERN EUROPE-EU,SPAIN,LONDON CITY,IBIZA, 4224 , 4224 , 0 , 3352 , 3352 , 0 , 26.0143198090692 
05-May-2016 09:32,201603,WESTERN EUROPE-EU,SPAIN,LONDON CITY,MADRID, 7384 , 7384 , 0 , 8850 , 8850 , 0 ,-16.5649717514124 
05-May-2016 09:32,201603,WESTERN EUROPE-EU,SPAIN,LONDON CITY,MALAGA, 3392 , 3392 , 0 , 4217 , 4217 , 0 ,-19.5636708560588 
05-May-2016 09:32,201603,WESTERN EUROPE-EU,SPAIN,LONDON CITY,PALMA DE MALLORCA, 1571 , 1571 , 0 , 2578 , 2578 , 0 ,-39.0612878200155 
05-May-2016 09:32,201603,WESTERN EUROPE-EU,SPAIN,LUTON,ALICANTE, 16357 , 16357 , 0 , 9470 , 9470 , 0 , 72.7243928194298 
05-May-2016 09:32,201603,WESTERN EUROPE-EU,SPAIN,LUTON,BARCELONA, 22468 , 22306 , 162 , 16177 , 16177 , 0 , 38.8885454657848 
05-May-2016 09:32,201603,WESTERN EUROPE-EU,SPAIN,LUTON,GIRONA, 2581 , 2581 , 0 , 613 , 613 , 0 , 321.044045676998 
05-May-2016 09:32,201603,WESTERN EUROPE-EU,SPAIN,LUTON,MADRID, 12434 , 12434 , 0 , 15042 , 15042 , 0 ,-17.3381199308603 
05-May-2016 09:32,201603,WESTERN EUROPE-EU,SPAIN,LUTON,MAHON, 285 , 285 , 0 , 224 , 224 , 0 , 27.2321428571429 
05-May-2016 09:32,201603,WESTERN EUROPE-EU,SPAIN,LUTON,MALAGA, 16146 , 15961 , 185 , 12840 , 12840 , 0 , 25.7476635514019 
05-May-2016 09:32,201603,WESTERN EUROPE-EU,SPAIN,LUTON,MURCIA SAN JAVIER, 4080 , 4080 , 0 , 721 , 721 , 0 , 465.880721220527 
05-May-2016 09:32,201603,WESTERN EUROPE-EU,SPAIN,LUTON,PALMA DE MALLORCA, 4133 , 3950 , 183 , 3309 , 2935 , 374 , 24.9017830160169 
05-May-2016 09:32,201603,WESTERN EUROPE-EU,SPAIN,LUTON,VIGO, 319 , 319 , 0 , 158 , 0 , 158 , 101.898734177215 
05-May-2016 09:32,201603,WESTERN EUROPE-EU,SPAIN,MANCHESTER,ALICANTE, 47822 , 42478 , 5344 , 38497 , 33279 , 5218 , 24.2226667013014 
05-May-2016 09:32,201603,WESTERN EUROPE-EU,SPAIN,MANCHESTER,ALMERIA, 2148 , 1652 , 496 , 0 , 0 , 0 , 0 
05-May-2016 09:32,201603,WESTERN EUROPE-EU,SPAIN,MANCHESTER,BARCELONA, 29411 , 29411 , 0 , 18862 , 16800 , 2062 , 55.9272611600042 
05-May-2016 09:32,201603,WESTERN EUROPE-EU,SPAIN,MANCHESTER,BILBAO, 2545 , 2545 , 0 , 3050 , 3050 , 0 ,-16.5573770491803 
05-May-2016 09:32,201603,WESTERN EUROPE-EU,SPAIN,MANCHESTER,GIRONA, 2175 , 2175 , 0 , 277 , 277 , 0 , 685.198555956679 
05-May-2016 09:32,201603,WESTERN EUROPE-EU,SPAIN,MANCHESTER,IBIZA, 2117 , 2117 , 0 , 428 , 428 , 0 , 394.626168224299 
05-May-2016 09:32,201603,WESTERN EUROPE-EU,SPAIN,MANCHESTER,LIEIDA, 1675 , 0 , 1675 , 2118 , 0 , 2118 ,-20.9159584513692 
05-May-2016 09:32,201603,WESTERN EUROPE-EU,SPAIN,MANCHESTER,MADRID, 13789 , 13789 , 0 , 7617 , 7617 , 0 , 81.0292766180911 
05-May-2016 09:32,201603,WESTERN EUROPE-EU,SPAIN,MANCHESTER,MALAGA, 39734 , 35042 , 4692 , 31955 , 26813 , 5142 , 24.3436081990299 
05-May-2016 09:32,201603,WESTERN EUROPE-EU,SPAIN,MANCHESTER,MURCIA SAN JAVIER, 4094 , 4094 , 0 , 865 , 865 , 0 , 373.294797687861 
05-May-2016 09:32,201603,WESTERN EUROPE-EU,SPAIN,MANCHESTER,PALMA DE MALLORCA, 19672 , 16103 , 3569 , 9416 , 5892 , 3524 , 108.9209855565 
05-May-2016 09:32,201603,WESTERN EUROPE-EU,SPAIN,MANCHESTER,SEVILLE, 0 , 0 , 0 , 256 , 0 , 256 , 0 
05-May-2016 09:32,201603,WESTERN EUROPE-EU,SPAIN,MANCHESTER,VALENCIA, 2103 , 2103 , 0 , 343 , 343 , 0 , 513.119533527697 
05-May-2016 09:32,201603,WESTERN EUROPE-EU,SPAIN,NEWCASTLE,ALICANTE, 23133 , 21101 , 2032 , 14413 , 12274 , 2139 , 60.5009366544092 
05-May-2016 09:32,201603,WESTERN EUROPE-EU,SPAIN,NEWCASTLE,BARCELONA, 6591 , 6485 , 106 , 5691 , 5691 , 0 , 15.8144438587243 
05-May-2016 09:32,201603,WESTERN EUROPE-EU,SPAIN,NEWCASTLE,MALAGA, 11570 , 9942 , 1628 , 11253 , 9443 , 1810 , 2.81702657069226 
05-May-2016 09:32,201603,WESTERN EUROPE-EU,SPAIN,NEWCASTLE,MURCIA SAN JAVIER, 661 , 661 , 0 , 248 , 248 , 0 , 166.532258064516 
05-May-2016 09:32,201603,WESTERN EUROPE-EU,SPAIN,NEWCASTLE,PALMA DE MALLORCA, 2161 , 1314 , 847 , 582 , 212 , 370 , 271.305841924399 
05-May-2016 09:32,201603,WESTERN EUROPE-EU,SPAIN,NORWICH,ALICANTE, 206 , 206 , 0 , 0 , 0 , 0 , 0 
05-May-2016 09:32,201603,WESTERN EUROPE-EU,SPAIN,NORWICH,MALAGA, 374 , 374 , 0 , 0 , 0 , 0 , 0 
05-May-2016 09:32,201603,WESTERN EUROPE-EU,SPAIN,PRESTWICK,ALICANTE, 6764 , 6764 , 0 , 3207 , 3207 , 0 , 110.913626442158 
05-May-2016 09:32,201603,WESTERN EUROPE-EU,SPAIN,PRESTWICK,BARCELONA, 4092 , 4092 , 0 , 917 , 917 , 0 , 346.237731733915 
05-May-2016 09:32,201603,WESTERN EUROPE-EU,SPAIN,PRESTWICK,GIRONA, 0 , 0 , 0 , 2780 , 2780 , 0 , 0 
05-May-2016 09:32,201603,WESTERN EUROPE-EU,SPAIN,PRESTWICK,IBIZA, 487 , 487 , 0 , 194 , 194 , 0 , 151.030927835052 
05-May-2016 09:32,201603,WESTERN EUROPE-EU,SPAIN,PRESTWICK,MALAGA, 4663 , 4663 , 0 , 3606 , 3606 , 0 , 29.312257348863 
05-May-2016 09:32,201603,WESTERN EUROPE-EU,SPAIN,PRESTWICK,MURCIA SAN JAVIER, 1291 , 1291 , 0 , 253 , 253 , 0 , 410.276679841897 
05-May-2016 09:32,201603,WESTERN EUROPE-EU,SPAIN,PRESTWICK,PALMA DE MALLORCA, 2242 , 2242 , 0 , 430 , 430 , 0 , 421.395348837209 
05-May-2016 09:32,201603,WESTERN EUROPE-EU,SPAIN,SOUTHAMPTON,ALICANTE, 1455 , 1455 , 0 , 2330 , 2330 , 0 ,-37.5536480686695 
05-May-2016 09:32,201603,WESTERN EUROPE-EU,SPAIN,SOUTHAMPTON,LIEIDA, 0 , 0 , 0 , 764 , 0 , 764 , 0 
05-May-2016 09:32,201603,WESTERN EUROPE-EU,SPAIN,SOUTHAMPTON,MALAGA, 718 , 718 , 0 , 2214 , 2214 , 0 ,-67.5700090334237 
05-May-2016 09:32,201603,WESTERN EUROPE-EU,SPAIN,SOUTHEND,ALICANTE, 9475 , 9475 , 0 , 9402 , 9402 , 0 , 0.776430546692193 
05-May-2016 09:32,201603,WESTERN EUROPE-EU,SPAIN,SOUTHEND,BARCELONA, 2362 , 2362 , 0 , 8138 , 8138 , 0 ,-70.9756696977144 
05-May-2016 09:32,201603,WESTERN EUROPE-EU,SPAIN,SOUTHEND,MALAGA, 5287 , 5287 , 0 , 5963 , 5963 , 0 ,-11.3365755492202 
05-May-2016 09:32,201603,WESTERN EUROPE-EU,SPAIN,SOUTHEND,PALMA DE MALLORCA, 0 , 0 , 0 , 405 , 405 , 0 , 0 
05-May-2016 09:32,201603,WESTERN EUROPE-EU,SPAIN,STANSTED,ALICANTE, 16953 , 16953 , 0 , 13360 , 13360 , 0 , 26.8937125748503 
05-May-2016 09:32,201603,WESTERN EUROPE-EU,SPAIN,STANSTED,ALMERIA, 1400 , 1400 , 0 , 280 , 280 , 0 , 400 
05-May-2016 09:32,201603,WESTERN EUROPE-EU,SPAIN,STANSTED,ASTURIAS, 6607 , 6607 , 0 , 5588 , 5588 , 0 , 18.2355046528275 
05-May-2016 09:32,201603,WESTERN EUROPE-EU,SPAIN,STANSTED,BARCELONA, 44903 , 44657 , 246 , 41857 , 41857 , 0 , 7.27715794251858 
05-May-2016 09:32,201603,WESTERN EUROPE-EU,SPAIN,STANSTED,BILBAO, 7855 , 7855 , 0 , 7793 , 7793 , 0 , 0.795585782112152 
05-May-2016 09:32,201603,WESTERN EUROPE-EU,SPAIN,STANSTED,CASTELLON DE LA PLANA AIRPORT, 4524 , 4524 , 0 , 0 , 0 , 0 , 0 
05-May-2016 09:32,201603,WESTERN EUROPE-EU,SPAIN,STANSTED,GIRONA, 1971 , 1971 , 0 , 575 , 575 , 0 , 242.782608695652 
05-May-2016 09:32,201603,WESTERN EUROPE-EU,SPAIN,STANSTED,IBIZA, 4674 , 4674 , 0 , 841 , 841 , 0 , 455.76694411415 
05-May-2016 09:32,201603,WESTERN EUROPE-EU,SPAIN,STANSTED,JEREZ, 2399 , 2399 , 0 , 674 , 674 , 0 , 255.93471810089 
05-May-2016 09:32,201603,WESTERN EUROPE-EU,SPAIN,STANSTED,MADRID, 43283 , 43283 , 0 , 33924 , 33924 , 0 , 27.588138191251 
05-May-2016 09:32,201603,WESTERN EUROPE-EU,SPAIN,STANSTED,MALAGA, 26725 , 26725 , 0 , 24047 , 24047 , 0 , 11.1365243065663 
05-May-2016 09:32,201603,WESTERN EUROPE-EU,SPAIN,STANSTED,MURCIA SAN JAVIER, 8964 , 8964 , 0 , 6847 , 6847 , 0 , 30.9186505038703 
05-May-2016 09:32,201603,WESTERN EUROPE-EU,SPAIN,STANSTED,PALMA DE MALLORCA, 18771 , 18771 , 0 , 16406 , 16223 , 183 , 14.4154577593563 
05-May-2016 09:32,201603,WESTERN EUROPE-EU,SPAIN,STANSTED,REUS, 3982 , 3982 , 0 , 3012 , 3012 , 0 , 32.2045152722444 
05-May-2016 09:32,201603,WESTERN EUROPE-EU,SPAIN,STANSTED,SANTANDER, 6773 , 6773 , 0 , 7301 , 7301 , 0 ,-7.23188604300781 
05-May-2016 09:32,201603,WESTERN EUROPE-EU,SPAIN,STANSTED,SANTIAGO DE COMPOSTELA (SPAIN), 6251 , 6251 , 0 , 4630 , 4630 , 0 , 35.0107991360691 
05-May-2016 09:32,201603,WESTERN EUROPE-EU,SPAIN,STANSTED,SEVILLE, 10749 , 10749 , 0 , 11057 , 11057 , 0 ,-2.78556570498327 
05-May-2016 09:32,201603,WESTERN EUROPE-EU,SPAIN,STANSTED,VALENCIA, 10424 , 10424 , 0 , 10960 , 10960 , 0 ,-4.89051094890511 
05-May-2016 09:32,201603,WESTERN EUROPE-EU,SPAIN,STANSTED,ZARAGOZA, 7974 , 7974 , 0 , 7618 , 7618 , 0 , 4.6731425571016 
05-May-2016 09:32,201603,WESTERN EUROPE-EU,SPAIN(CANARY ISLANDS),ABERDEEN,TENERIFE (SURREINA SOFIA), 3302 , 0 , 3302 , 3339 , 0 , 3339 ,-1.10811620245583 
05-May-2016 09:32,201603,WESTERN EUROPE-EU,SPAIN(CANARY ISLANDS),BELFAST INTERNATIONAL,ARRECIFE, 9390 , 5504 , 3886 , 6412 , 6412 , 0 , 46.4441671865253 
05-May-2016 09:32,201603,WESTERN EUROPE-EU,SPAIN(CANARY ISLANDS),BELFAST INTERNATIONAL,LAS PALMAS, 2802 , 1104 , 1698 , 2077 , 2077 , 0 , 34.9061145883486 
05-May-2016 09:32,201603,WESTERN EUROPE-EU,SPAIN(CANARY ISLANDS),BELFAST INTERNATIONAL,TENERIFE (SURREINA SOFIA), 8151 , 2617 , 5534 , 7848 , 7848 , 0 , 3.86085626911315 
05-May-2016 09:32,201603,WESTERN EUROPE-EU,SPAIN(CANARY ISLANDS),BIRMINGHAM,ARRECIFE, 18542 , 12987 , 5555 , 18617 , 13106 , 5511 ,-0.402857603265832 
05-May-2016 09:32,201603,WESTERN EUROPE-EU,SPAIN(CANARY ISLANDS),BIRMINGHAM,FUERTEVENTURA, 12811 , 8886 , 3925 , 8488 , 6813 , 1675 , 50.930725730443 
05-May-2016 09:32,201603,WESTERN EUROPE-EU,SPAIN(CANARY ISLANDS),BIRMINGHAM,LAS PALMAS, 12379 , 7249 , 5130 , 8385 , 4910 , 3475 , 47.6326774001193 
05-May-2016 09:32,201603,WESTERN EUROPE-EU,SPAIN(CANARY ISLANDS),BIRMINGHAM,TENERIFE (SURREINA SOFIA), 30633 , 23111 , 7522 , 22527 , 16853 , 5674 , 35.9834864828872 
05-May-2016 09:32,201603,WESTERN EUROPE-EU,SPAIN(CANARY ISLANDS),BOURNEMOUTH,ARRECIFE, 1641 , 0 , 1641 , 1858 , 0 , 1858 ,-11.6792249730893 
05-May-2016 09:32,201603,WESTERN EUROPE-EU,SPAIN(CANARY ISLANDS),BOURNEMOUTH,LAS PALMAS, 1897 , 472 , 1425 , 1772 , 0 , 1772 , 7.05417607223476 
05-May-2016 09:32,201603,WESTERN EUROPE-EU,SPAIN(CANARY ISLANDS),BOURNEMOUTH,TENERIFE (SURREINA SOFIA), 4990 , 1712 , 3278 , 4926 , 1676 , 3250 , 1.29922858302883 
05-May-2016 09:32,201603,WESTERN EUROPE-EU,SPAIN(CANARY ISLANDS),BRISTOL,ARRECIFE, 13542 , 7510 , 6032 , 10648 , 8500 , 2148 , 27.1788129226146 
05-May-2016 09:32,201603,WESTERN EUROPE-EU,SPAIN(CANARY ISLANDS),BRISTOL,FUERTEVENTURA, 8601 , 3042 , 5559 , 7707 , 6018 , 1689 , 11.599844297392 
05-May-2016 09:32,201603,WESTERN EUROPE-EU,SPAIN(CANARY ISLANDS),BRISTOL,LAS PALMAS, 7034 , 2034 , 5000 , 5578 , 3836 , 1742 , 26.1025457153102 
05-May-2016 09:32,201603,WESTERN EUROPE-EU,SPAIN(CANARY ISLANDS),BRISTOL,TENERIFE (SURREINA SOFIA), 16590 , 8923 , 7667 , 16210 , 12723 , 3487 , 2.34423195558297 
05-May-2016 09:32,201603,WESTERN EUROPE-EU,SPAIN(CANARY ISLANDS),CARDIFF WALES,ARRECIFE, 3107 , 0 , 3107 , 1833 , 0 , 1833 , 69.5035460992908 
05-May-2016 09:32,201603,WESTERN EUROPE-EU,SPAIN(CANARY ISLANDS),CARDIFF WALES,LAS PALMAS, 1353 , 0 , 1353 , 1762 , 0 , 1762 ,-23.2122587968218 
05-May-2016 09:32,201603,WESTERN EUROPE-EU,SPAIN(CANARY ISLANDS),CARDIFF WALES,TENERIFE (SURREINA SOFIA), 4362 , 1056 , 3306 , 5984 , 1365 , 4619 ,-27.105614973262 
05-May-2016 09:32,201603,WESTERN EUROPE-EU,SPAIN(CANARY ISLANDS),DONCASTER SHEFFIELD,ARRECIFE, 3087 , 0 , 3087 , 1867 , 0 , 1867 , 65.345474022496 
05-May-2016 09:32,201603,WESTERN EUROPE-EU,SPAIN(CANARY ISLANDS),DONCASTER SHEFFIELD,LAS PALMAS, 1490 , 0 , 1490 , 1643 , 0 , 1643 ,-9.31223371880706 
05-May-2016 09:32,201603,WESTERN EUROPE-EU,SPAIN(CANARY ISLANDS),DONCASTER SHEFFIELD,TENERIFE (SURREINA SOFIA), 4984 , 0 , 4984 , 3110 , 0 , 3110 , 60.2572347266881 
05-May-2016 09:32,201603,WESTERN EUROPE-EU,SPAIN(CANARY ISLANDS),EAST MIDLANDS INTERNATIONAL,ARRECIFE, 19138 , 15775 , 3363 , 19753 , 16284 , 3469 ,-3.11345112134866 
05-May-2016 09:32,201603,WESTERN EUROPE-EU,SPAIN(CANARY ISLANDS),EAST MIDLANDS INTERNATIONAL,FUERTEVENTURA, 10827 , 8975 , 1852 , 8194 , 6744 , 1450 , 32.1332682450574 
05-May-2016 09:32,201603,WESTERN EUROPE-EU,SPAIN(CANARY ISLANDS),EAST MIDLANDS INTERNATIONAL,LAS PALMAS, 10356 , 7213 , 3143 , 5554 , 3772 , 1782 , 86.4602088584804 
05-May-2016 09:32,201603,WESTERN EUROPE-EU,SPAIN(CANARY ISLANDS),EAST MIDLANDS INTERNATIONAL,TENERIFE (SURREINA SOFIA), 27115 , 22353 , 4762 , 27805 , 22833 , 4972 ,-2.48156806329797 
05-May-2016 09:32,201603,WESTERN EUROPE-EU,SPAIN(CANARY ISLANDS),EDINBURGH,ARRECIFE, 6114 , 4272 , 1842 , 4985 , 3265 , 1720 , 22.6479438314945 
05-May-2016 09:32,201603,WESTERN EUROPE-EU,SPAIN(CANARY ISLANDS),EDINBURGH,FUERTEVENTURA, 1831 , 1831 , 0 , 1436 , 1436 , 0 , 27.5069637883008 
05-May-2016 09:32,201603,WESTERN EUROPE-EU,SPAIN(CANARY ISLANDS),EDINBURGH,LAS PALMAS, 4003 , 2701 , 1302 , 249 , 249 , 0 , 1507.63052208835 
05-May-2016 09:32,201603,WESTERN EUROPE-EU,SPAIN(CANARY ISLANDS),EDINBURGH,TENERIFE (SURREINA SOFIA), 18626 , 15416 , 3210 , 11324 , 7800 , 3524 , 64.4825150123631 
05-May-2016 09:32,201603,WESTERN EUROPE-EU,SPAIN(CANARY ISLANDS),EXETER,ARRECIFE, 3275 , 0 , 3275 , 1843 , 0 , 1843 , 77.6994031470429 
05-May-2016 09:32,201603,WESTERN EUROPE-EU,SPAIN(CANARY ISLANDS),EXETER,LAS PALMAS, 1439 , 0 , 1439 , 1828 , 0 , 1828 ,-21.2800875273523 
05-May-2016 09:32,201603,WESTERN EUROPE-EU,SPAIN(CANARY ISLANDS),EXETER,TENERIFE (SURREINA SOFIA), 4745 , 0 , 4745 , 4578 , 0 , 4578 , 3.64788117081695 
05-May-2016 09:32,201603,WESTERN EUROPE-EU,SPAIN(CANARY ISLANDS),GATWICK,ARRECIFE, 37760 , 30560 , 7200 , 36139 , 28289 , 7850 , 4.4854589224937 
05-May-2016 09:32,201603,WESTERN EUROPE-EU,SPAIN(CANARY ISLANDS),GATWICK,FUERTEVENTURA, 30877 , 25116 , 5761 , 22279 , 19300 , 2979 , 38.5923964271287 
05-May-2016 09:32,201603,WESTERN EUROPE-EU,SPAIN(CANARY ISLANDS),GATWICK,LAS PALMAS, 23160 , 17513 , 5647 , 23259 , 18337 , 4922 ,-0.425641687088869 
05-May-2016 09:32,201603,WESTERN EUROPE-EU,SPAIN(CANARY ISLANDS),GATWICK,SANTA CRUZ DE LA PALMA, 3127 , 0 , 3127 , 4663 , 1355 , 3308 ,-32.9401672742869 
05-May-2016 09:32,201603,WESTERN EUROPE-EU,SPAIN(CANARY ISLANDS),GATWICK,TENERIFE (SURREINA SOFIA), 70200 , 55957 , 14243 , 65843 , 54492 , 11351 , 6.61725620035539 
05-May-2016 09:32,201603,WESTERN EUROPE-EU,SPAIN(CANARY ISLANDS),GLASGOW,ARRECIFE, 10550 , 8405 , 2145 , 10530 , 8776 , 1754 , 0.189933523266857 
05-May-2016 09:32,201603,WESTERN EUROPE-EU,SPAIN(CANARY ISLANDS),GLASGOW,FUERTEVENTURA, 7041 , 5313 , 1728 , 6801 , 5123 , 1678 , 3.5288928098809 
05-May-2016 09:32,201603,WESTERN EUROPE-EU,SPAIN(CANARY ISLANDS),GLASGOW,LAS PALMAS, 4750 , 3081 , 1669 , 5553 , 3615 , 1938 ,-14.4606518998739 
05-May-2016 09:32,201603,WESTERN EUROPE-EU,SPAIN(CANARY ISLANDS),GLASGOW,TENERIFE (SURREINA SOFIA), 25791 , 18676 , 7115 , 21849 , 15948 , 5901 , 18.0420156528903 
05-May-2016 09:32,201603,WESTERN EUROPE-EU,SPAIN(CANARY ISLANDS),HEATHROW,LAS PALMAS, 7446 , 7446 , 0 , 1539 , 1539 , 0 , 383.820662768031 
05-May-2016 09:32,201603,WESTERN EUROPE-EU,SPAIN(CANARY ISLANDS),HEATHROW,TENERIFE (NORTE LOS RODEOS), 3792 , 3792 , 0 , 568 , 568 , 0 , 567.605633802817 
05-May-2016 09:32,201603,WESTERN EUROPE-EU,SPAIN(CANARY ISLANDS),JERSEY,TENERIFE (SURREINA SOFIA), 906 , 906 , 0 , 586 , 586 , 0 , 54.6075085324232 
05-May-2016 09:32,201603,WESTERN EUROPE-EU,SPAIN(CANARY ISLANDS),LEEDS BRADFORD,ARRECIFE, 8490 , 8490 , 0 , 10761 , 10761 , 0 ,-21.103986618344 
05-May-2016 09:32,201603,WESTERN EUROPE-EU,SPAIN(CANARY ISLANDS),LEEDS BRADFORD,FUERTEVENTURA, 4324 , 4324 , 0 , 4673 , 4673 , 0 ,-7.46843569441472 
05-May-2016 09:32,201603,WESTERN EUROPE-EU,SPAIN(CANARY ISLANDS),LEEDS BRADFORD,LAS PALMAS, 2895 , 2895 , 0 , 2252 , 2252 , 0 , 28.5523978685613 
05-May-2016 09:32,201603,WESTERN EUROPE-EU,SPAIN(CANARY ISLANDS),LEEDS BRADFORD,TENERIFE (SURREINA SOFIA), 15482 , 14018 , 1464 , 14670 , 13181 , 1489 , 5.53510565780504 
05-May-2016 09:32,201603,WESTERN EUROPE-EU,SPAIN(CANARY ISLANDS),LIVERPOOL (JOHN LENNON),ARRECIFE, 5861 , 5861 , 0 , 6139 , 6139 , 0 ,-4.52842482489005 
05-May-2016 09:32,201603,WESTERN EUROPE-EU,SPAIN(CANARY ISLANDS),LIVERPOOL (JOHN LENNON),FUERTEVENTURA, 5291 , 5291 , 0 , 4469 , 4469 , 0 , 18.3933765943164 
05-May-2016 09:32,201603,WESTERN EUROPE-EU,SPAIN(CANARY ISLANDS),LIVERPOOL (JOHN LENNON),LAS PALMAS, 623 , 623 , 0 , 0 , 0 , 0 , 0 
05-May-2016 09:32,201603,WESTERN EUROPE-EU,SPAIN(CANARY ISLANDS),LIVERPOOL (JOHN LENNON),TENERIFE (SURREINA SOFIA), 2257 , 2139 , 118 , 1743 , 1743 , 0 , 29.4893861158921 
05-May-2016 09:32,201603,WESTERN EUROPE-EU,SPAIN(CANARY ISLANDS),LUTON,ARRECIFE, 10014 , 8269 , 1745 , 9234 , 7439 , 1795 , 8.44704353476283 
05-May-2016 09:32,201603,WESTERN EUROPE-EU,SPAIN(CANARY ISLANDS),LUTON,FUERTEVENTURA, 1432 , 1432 , 0 , 270 , 270 , 0 , 430.37037037037 
05-May-2016 09:32,201603,WESTERN EUROPE-EU,SPAIN(CANARY ISLANDS),LUTON,LAS PALMAS, 2766 , 1424 , 1342 , 1962 , 349 , 1613 , 40.9785932721713 
05-May-2016 09:32,201603,WESTERN EUROPE-EU,SPAIN(CANARY ISLANDS),LUTON,TENERIFE (SURREINA SOFIA), 12917 , 9611 , 3306 , 9759 , 6519 , 3240 , 32.359872937801 
05-May-2016 09:32,201603,WESTERN EUROPE-EU,SPAIN(CANARY ISLANDS),MANCHESTER,ARRECIFE, 37422 , 30484 , 6938 , 29582 , 22528 , 7054 , 26.5026029342168 
05-May-2016 09:32,201603,WESTERN EUROPE-EU,SPAIN(CANARY ISLANDS),MANCHESTER,FUERTEVENTURA, 18682 , 14275 , 4407 , 14956 , 11746 , 3210 , 24.9130783631987 
05-May-2016 09:32,201603,WESTERN EUROPE-EU,SPAIN(CANARY ISLANDS),MANCHESTER,LAS PALMAS, 18915 , 14058 , 4857 , 16140 , 10849 , 5291 , 17.1933085501859 
05-May-2016 09:32,201603,WESTERN EUROPE-EU,SPAIN(CANARY ISLANDS),MANCHESTER,SANTA CRUZ DE LA PALMA, 1852 , 0 , 1852 , 1471 , 0 , 1471 , 25.9007477906186 
05-May-2016 09:32,201603,WESTERN EUROPE-EU,SPAIN(CANARY ISLANDS),MANCHESTER,TENERIFE (SURREINA SOFIA), 72284 , 56661 , 15623 , 60659 , 49051 , 11608 , 19.1645098006891 
05-May-2016 09:32,201603,WESTERN EUROPE-EU,SPAIN(CANARY ISLANDS),NEWCASTLE,ARRECIFE, 7268 , 3109 , 4159 , 6371 , 4875 , 1496 , 14.0794223826715 
05-May-2016 09:32,201603,WESTERN EUROPE-EU,SPAIN(CANARY ISLANDS),NEWCASTLE,FUERTEVENTURA, 3108 , 1448 , 1660 , 1727 , 1727 , 0 , 79.965257672264 
05-May-2016 09:32,201603,WESTERN EUROPE-EU,SPAIN(CANARY ISLANDS),NEWCASTLE,LAS PALMAS, 4508 , 1624 , 2884 , 3586 , 1746 , 1840 , 25.7110987172337 
05-May-2016 09:32,201603,WESTERN EUROPE-EU,SPAIN(CANARY ISLANDS),NEWCASTLE,TENERIFE (SURREINA SOFIA), 20255 , 8062 , 12193 , 18506 , 13531 , 4975 , 9.45098886847509 
05-May-2016 09:32,201603,WESTERN EUROPE-EU,SPAIN(CANARY ISLANDS),NORWICH,TENERIFE (SURREINA SOFIA), 3160 , 0 , 3160 , 1819 , 0 , 1819 , 73.7218251786696 
05-May-2016 09:32,201603,WESTERN EUROPE-EU,SPAIN(CANARY ISLANDS),PRESTWICK,ARRECIFE, 2903 , 2903 , 0 , 3233 , 3233 , 0 ,-10.2072378595732 
05-May-2016 09:32,201603,WESTERN EUROPE-EU,SPAIN(CANARY ISLANDS),PRESTWICK,FUERTEVENTURA, 1425 , 1425 , 0 , 1822 , 1822 , 0 ,-21.7892425905598 
05-May-2016 09:32,201603,WESTERN EUROPE-EU,SPAIN(CANARY ISLANDS),PRESTWICK,LAS PALMAS, 2301 , 2301 , 0 , 1711 , 1711 , 0 , 34.4827586206897 
05-May-2016 09:32,201603,WESTERN EUROPE-EU,SPAIN(CANARY ISLANDS),PRESTWICK,TENERIFE (SURREINA SOFIA), 6547 , 6547 , 0 , 5057 , 5057 , 0 , 29.4641091556259 
05-May-2016 09:32,201603,WESTERN EUROPE-EU,SPAIN(CANARY ISLANDS),SOUTHEND,ARRECIFE, 2904 , 2904 , 0 , 0 , 0 , 0 , 0 
05-May-2016 09:32,201603,WESTERN EUROPE-EU,SPAIN(CANARY ISLANDS),SOUTHEND,TENERIFE (SURREINA SOFIA), 2809 , 2809 , 0 , 2760 , 2760 , 0 , 1.77536231884058 
05-May-2016 09:32,201603,WESTERN EUROPE-EU,SPAIN(CANARY ISLANDS),STANSTED,ARRECIFE, 12508 , 10678 , 1830 , 9938 , 8422 , 1516 , 25.8603340712417 
05-May-2016 09:32,201603,WESTERN EUROPE-EU,SPAIN(CANARY ISLANDS),STANSTED,FUERTEVENTURA, 9504 , 7652 , 1852 , 9503 , 8039 , 1464 , 0.010522992739135 
05-May-2016 09:32,201603,WESTERN EUROPE-EU,SPAIN(CANARY ISLANDS),STANSTED,LAS PALMAS, 9752 , 8276 , 1476 , 6889 , 5010 , 1879 , 41.5590071127885 
05-May-2016 09:32,201603,WESTERN EUROPE-EU,SPAIN(CANARY ISLANDS),STANSTED,SANTA CRUZ DE LA PALMA, 186 , 0 , 186 , 0 , 0 , 0 , 0 
05-May-2016 09:32,201603,WESTERN EUROPE-EU,SPAIN(CANARY ISLANDS),STANSTED,TENERIFE (SURREINA SOFIA), 20999 , 17689 , 3310 , 18230 , 14988 , 3242 , 15.1892484914975 
05-May-2016 09:32,201603,INDIAN SUB-CONTINENT,SRI LANKA,GATWICK,COLOMBO, 0 , 0 , 0 , 5649 , 5649 , 0 , 0 
05-May-2016 09:32,201603,INDIAN SUB-CONTINENT,SRI LANKA,HEATHROW,COLOMBO, 20340 , 20340 , 0 , 19075 , 19075 , 0 , 6.63171690694627 
05-May-2016 09:32,201603,CARIBBEAN AREA,ST LUCIA,GATWICK,ST LUCIA (HEWANORRA), 1603 , 1603 , 0 , 4553 , 4553 , 0 ,-64.7924445420602 
05-May-2016 09:32,201603,CARIBBEAN AREA,ST LUCIA,MANCHESTER,ST LUCIA (HEWANORRA), 871 , 871 , 0 , 0 , 0 , 0 , 0 
05-May-2016 09:32,201603,WESTERN EUROPE-EU,SWEDEN,BIRMINGHAM,ARVIDSJAUR, 98 , 0 , 98 , 0 , 0 , 0 , 0 
05-May-2016 09:32,201603,WESTERN EUROPE-EU,SWEDEN,BIRMINGHAM,GOTEBORG (LANDVETTER), 0 , 0 , 0 , 1191 , 1191 , 0 , 0 
05-May-2016 09:32,201603,WESTERN EUROPE-EU,SWEDEN,BIRMINGHAM,KIRUNA, 228 , 0 , 228 , 140 , 0 , 140 , 62.8571428571429 
05-May-2016 09:32,201603,WESTERN EUROPE-EU,SWEDEN,BRISTOL,KIRUNA, 0 , 0 , 0 , 69 , 0 , 69 , 0 
05-May-2016 09:32,201603,WESTERN EUROPE-EU,SWEDEN,EAST MIDLANDS INTERNATIONAL,KIRUNA, 0 , 0 , 0 , 53 , 0 , 53 , 0 
05-May-2016 09:32,201603,WESTERN EUROPE-EU,SWEDEN,EDINBURGH,GOTEBORG (LANDVETTER), 981 , 981 , 0 , 200 , 200 , 0 , 390.5 
05-May-2016 09:32,201603,WESTERN EUROPE-EU,SWEDEN,EDINBURGH,STOCKHOLM (ARLANDA), 3472 , 3472 , 0 , 945 , 945 , 0 , 267.407407407407 
05-May-2016 09:32,201603,WESTERN EUROPE-EU,SWEDEN,GATWICK,GOTEBORG (LANDVETTER), 13735 , 13735 , 0 , 4109 , 4109 , 0 , 234.266244828425 
05-May-2016 09:32,201603,WESTERN EUROPE-EU,SWEDEN,GATWICK,KIRUNA, 358 , 0 , 358 , 133 , 0 , 133 , 169.172932330827 
05-May-2016 09:32,201603,WESTERN EUROPE-EU,SWEDEN,GATWICK,STOCKHOLM (ARLANDA), 39250 , 39250 , 0 , 36239 , 36239 , 0 , 8.30872816578824 
05-May-2016 09:32,201603,WESTERN EUROPE-EU,SWEDEN,HEATHROW,GOTEBORG (LANDVETTER), 23941 , 23941 , 0 , 23725 , 23725 , 0 , 0.910432033719705 
05-May-2016 09:32,201603,WESTERN EUROPE-EU,SWEDEN,HEATHROW,KIRUNA, 627 , 0 , 627 , 339 , 0 , 339 , 84.9557522123894 
05-May-2016 09:32,201603,WESTERN EUROPE-EU,SWEDEN,HEATHROW,STOCKHOLM (ARLANDA), 85852 , 85852 , 0 , 82127 , 82127 , 0 , 4.53565818792845 
05-May-2016 09:32,201603,WESTERN EUROPE-EU,SWEDEN,HUMBERSIDE,KIRUNA, 101 , 0 , 101 , 0 , 0 , 0 , 0 
05-May-2016 09:32,201603,WESTERN EUROPE-EU,SWEDEN,LEEDS BRADFORD,KIRUNA, 220 , 0 , 220 , 0 , 0 , 0 , 0 
05-May-2016 09:32,201603,WESTERN EUROPE-EU,SWEDEN,MANCHESTER,GOTEBORG (LANDVETTER), 705 , 705 , 0 , 0 , 0 , 0 , 0 
05-May-2016 09:32,201603,WESTERN EUROPE-EU,SWEDEN,MANCHESTER,KIRUNA, 214 , 0 , 214 , 146 , 0 , 146 , 46.5753424657534 
05-May-2016 09:32,201603,WESTERN EUROPE-EU,SWEDEN,MANCHESTER,STOCKHOLM (ARLANDA), 10750 , 10750 , 0 , 8618 , 8618 , 0 , 24.7389185425853 
05-May-2016 09:32,201603,WESTERN EUROPE-EU,SWEDEN,NEWCASTLE,KIRUNA, 310 , 0 , 310 , 213 , 0 , 213 , 45.5399061032864 
05-May-2016 09:32,201603,WESTERN EUROPE-EU,SWEDEN,NEWCASTLE,STOCKHOLM (ARLANDA), 14 , 0 , 14 , 0 , 0 , 0 , 0 
05-May-2016 09:32,201603,WESTERN EUROPE-EU,SWEDEN,STANSTED,GOTEBORG (LANDVETTER), 23481 , 23481 , 0 , 16513 , 16513 , 0 , 42.1970568642887 
05-May-2016 09:32,201603,WESTERN EUROPE-EU,SWEDEN,STANSTED,SKELLEFTEA, 0 , 0 , 0 , 1860 , 1860 , 0 , 0 
05-May-2016 09:32,201603,WESTERN EUROPE-EU,SWEDEN,STANSTED,STOCKHOLM (SKAVSTA), 21551 , 21551 , 0 , 20038 , 20038 , 0 , 7.55065375786007 
05-May-2016 09:32,201603,WESTERN EUROPE-EU,SWEDEN,STANSTED,VASTERAS, 5412 , 5412 , 0 , 5567 , 5567 , 0 ,-2.78426441530447 
05-May-2016 09:32,201603,WESTERN EUROPE-OTHER,SWITZERLAND,ABERDEEN,GENEVA, 1027 , 894 , 133 , 1024 , 1024 , 0 , 0.29296875 
05-May-2016 09:32,201603,WESTERN EUROPE-OTHER,SWITZERLAND,BELFAST INTERNATIONAL,GENEVA, 6654 , 6654 , 0 , 7593 , 7459 , 134 ,-12.3666534966416 
05-May-2016 09:32,201603,WESTERN EUROPE-OTHER,SWITZERLAND,BIRMINGHAM,BERNE, 44 , 0 , 44 , 0 , 0 , 0 , 0 
05-May-2016 09:32,201603,WESTERN EUROPE-OTHER,SWITZERLAND,BIRMINGHAM,GENEVA, 16980 , 15630 , 1350 , 16140 , 13565 , 2575 , 5.20446096654275 
05-May-2016 09:32,201603,WESTERN EUROPE-OTHER,SWITZERLAND,BIRMINGHAM,ZURICH, 7861 , 7861 , 0 , 8636 , 8636 , 0 ,-8.97406206577119 
05-May-2016 09:32,201603,WESTERN EUROPE-OTHER,SWITZERLAND,BOURNEMOUTH,GENEVA, 7718 , 7718 , 0 , 7462 , 7462 , 0 , 3.43071562583758 
05-May-2016 09:32,201603,WESTERN EUROPE-OTHER,SWITZERLAND,BOURNEMOUTH,ZURICH, 0 , 0 , 0 , 46 , 0 , 46 , 0 
05-May-2016 09:32,201603,WESTERN EUROPE-OTHER,SWITZERLAND,BRISTOL,BALE MULHOUSE, 3874 , 3874 , 0 , 0 , 0 , 0 , 0 
05-May-2016 09:32,201603,WESTERN EUROPE-OTHER,SWITZERLAND,BRISTOL,GENEVA, 30895 , 27706 , 3189 , 30737 , 27801 , 2936 , 0.514038455281908 
05-May-2016 09:32,201603,WESTERN EUROPE-OTHER,SWITZERLAND,CARDIFF WALES,GENEVA, 761 , 761 , 0 , 524 , 524 , 0 , 45.2290076335878 
05-May-2016 09:32,201603,WESTERN EUROPE-OTHER,SWITZERLAND,EAST MIDLANDS INTERNATIONAL,BERNE, 43 , 0 , 43 , 0 , 0 , 0 , 0 
05-May-2016 09:32,201603,WESTERN EUROPE-OTHER,SWITZERLAND,EAST MIDLANDS INTERNATIONAL,GENEVA, 1329 , 1329 , 0 , 1020 , 1020 , 0 , 30.2941176470588 
05-May-2016 09:32,201603,WESTERN EUROPE-OTHER,SWITZERLAND,EDINBURGH,BALE MULHOUSE, 5918 , 5918 , 0 , 4492 , 4492 , 0 , 31.7453250222618 
05-May-2016 09:32,201603,WESTERN EUROPE-OTHER,SWITZERLAND,EDINBURGH,GENEVA, 21910 , 19557 , 2353 , 19558 , 16718 , 2840 , 12.0257695060845 
05-May-2016 09:32,201603,WESTERN EUROPE-OTHER,SWITZERLAND,EXETER,GENEVA, 885 , 524 , 361 , 900 , 568 , 332 ,-1.66666666666667 
05-May-2016 09:32,201603,WESTERN EUROPE-OTHER,SWITZERLAND,GATWICK,BALE MULHOUSE, 22563 , 22563 , 0 , 23432 , 23432 , 0 ,-3.70860361898259 
05-May-2016 09:32,201603,WESTERN EUROPE-OTHER,SWITZERLAND,GATWICK,GENEVA, 114055 , 107925 , 6130 , 115919 , 100910 , 15009 ,-1.60801939285191 
05-May-2016 09:32,201603,WESTERN EUROPE-OTHER,SWITZERLAND,GATWICK,ZURICH, 13392 , 13392 , 0 , 15679 , 15679 , 0 ,-14.5863894381019 
05-May-2016 09:32,201603,WESTERN EUROPE-OTHER,SWITZERLAND,GLASGOW,GENEVA, 3167 , 3167 , 0 , 3594 , 3594 , 0 ,-11.8809126321647 
05-May-2016 09:32,201603,WESTERN EUROPE-OTHER,SWITZERLAND,HEATHROW,BALE MULHOUSE, 21413 , 21413 , 0 , 20284 , 20284 , 0 , 5.56596332084401 
05-May-2016 09:32,201603,WESTERN EUROPE-OTHER,SWITZERLAND,HEATHROW,GENEVA, 113673 , 112360 , 1313 , 111810 , 110973 , 837 , 1.66621947947411 
05-May-2016 09:32,201603,WESTERN EUROPE-OTHER,SWITZERLAND,HEATHROW,ZURICH, 96499 , 96499 , 0 , 84954 , 84954 , 0 , 13.5897073710479 
05-May-2016 09:32,201603,WESTERN EUROPE-OTHER,SWITZERLAND,INVERNESS,GENEVA, 435 , 435 , 0 , 470 , 470 , 0 ,-7.4468085106383 
05-May-2016 09:32,201603,WESTERN EUROPE-OTHER,SWITZERLAND,ISLE OF MAN,GENEVA, 511 , 511 , 0 , 545 , 545 , 0 ,-6.23853211009174 
05-May-2016 09:32,201603,WESTERN EUROPE-OTHER,SWITZERLAND,JERSEY,GENEVA, 1224 , 1224 , 0 , 1520 , 1520 , 0 ,-19.4736842105263 
05-May-2016 09:32,201603,WESTERN EUROPE-OTHER,SWITZERLAND,LEEDS BRADFORD,GENEVA, 10815 , 10815 , 0 , 10990 , 10990 , 0 ,-1.59235668789809 
05-May-2016 09:32,201603,WESTERN EUROPE-OTHER,SWITZERLAND,LEEDS BRADFORD,ZURICH, 1 , 0 , 1 , 0 , 0 , 0 , 0 
05-May-2016 09:32,201603,WESTERN EUROPE-OTHER,SWITZERLAND,LIVERPOOL (JOHN LENNON),GENEVA, 21797 , 21797 , 0 , 22131 , 22131 , 0 ,-1.50919524648683 
05-May-2016 09:32,201603,WESTERN EUROPE-OTHER,SWITZERLAND,LONDON CITY,BALE MULHOUSE, 1336 , 1336 , 0 , 6263 , 6263 , 0 ,-78.6683697908351 
05-May-2016 09:32,201603,WESTERN EUROPE-OTHER,SWITZERLAND,LONDON CITY,BERNE, 916 , 916 , 0 , 0 , 0 , 0 , 0 
05-May-2016 09:32,201603,WESTERN EUROPE-OTHER,SWITZERLAND,LONDON CITY,GENEVA, 23128 , 23128 , 0 , 17573 , 17573 , 0 , 31.6109941387356 
05-May-2016 09:32,201603,WESTERN EUROPE-OTHER,SWITZERLAND,LONDON CITY,ZURICH, 34435 , 34435 , 0 , 35788 , 35788 , 0 ,-3.78059684810551 
05-May-2016 09:32,201603,WESTERN EUROPE-OTHER,SWITZERLAND,LUTON,BALE MULHOUSE, 5948 , 5945 , 3 , 5808 , 5808 , 0 , 2.41046831955923 
05-May-2016 09:32,201603,WESTERN EUROPE-OTHER,SWITZERLAND,LUTON,GENEVA, 43356 , 43356 , 0 , 42475 , 42475 , 0 , 2.07416127133608 
05-May-2016 09:32,201603,WESTERN EUROPE-OTHER,SWITZERLAND,LUTON,ZURICH, 7537 , 7537 , 0 , 7672 , 7672 , 0 ,-1.75964546402503 
05-May-2016 09:32,201603,WESTERN EUROPE-OTHER,SWITZERLAND,MANCHESTER,BALE MULHOUSE, 6203 , 6203 , 0 , 6483 , 6483 , 0 ,-4.31898812278266 
05-May-2016 09:32,201603,WESTERN EUROPE-OTHER,SWITZERLAND,MANCHESTER,GENEVA, 27574 , 26199 , 1375 , 21972 , 18516 , 3456 , 25.4960859275441 
05-May-2016 09:32,201603,WESTERN EUROPE-OTHER,SWITZERLAND,MANCHESTER,ZURICH, 12499 , 12499 , 0 , 12443 , 12443 , 0 , 0.45005223820622 
05-May-2016 09:32,201603,WESTERN EUROPE-OTHER,SWITZERLAND,NEWCASTLE,GENEVA, 9172 , 7768 , 1404 , 8323 , 7400 , 923 , 10.2006488045176 
05-May-2016 09:32,201603,WESTERN EUROPE-OTHER,SWITZERLAND,SOUTHAMPTON,GENEVA, 1551 , 1551 , 0 , 2076 , 2076 , 0 ,-25.2890173410405 
05-May-2016 09:32,201603,WESTERN EUROPE-OTHER,SWITZERLAND,SOUTHEND,BERNE, 0 , 0 , 0 , 828 , 828 , 0 , 0 
05-May-2016 09:32,201603,WESTERN EUROPE-OTHER,SWITZERLAND,SOUTHEND,GENEVA, 7941 , 7941 , 0 , 7550 , 7550 , 0 , 5.17880794701987 
05-May-2016 09:32,201603,WESTERN EUROPE-OTHER,SWITZERLAND,STANSTED,BALE MULHOUSE, 9148 , 9148 , 0 , 7988 , 7988 , 0 , 14.521782674011 
05-May-2016 09:32,201603,WESTERN EUROPE-OTHER,SWITZERLAND,STANSTED,GENEVA, 17330 , 17184 , 146 , 15991 , 15991 , 0 , 8.3734600712901 
05-May-2016 09:32,201603,FAR EAST,TAIWAN,HEATHROW,TAIPEI, 1385 , 1385 , 0 , 10254 , 10254 , 0 ,-86.4930758728301 
05-May-2016 09:32,201603,FAR EAST,THAILAND,GATWICK,PHUKET, 2396 , 0 , 2396 , 2304 , 0 , 2304 , 3.99305555555556 
05-May-2016 09:32,201603,FAR EAST,THAILAND,HEATHROW,BANGKOK SUVARNABHUMI , 71163 , 71163 , 0 , 52379 , 52379 , 0 , 35.8617002997384 
05-May-2016 09:32,201603,CARIBBEAN AREA,TRINIDAD AND TOBAGO,GATWICK,PORT OF SPAIN, 9625 , 9625 , 0 , 13849 , 13849 , 0 ,-30.5003971405878 
05-May-2016 09:32,201603,CARIBBEAN AREA,TRINIDAD AND TOBAGO,GATWICK,TOBAGO, 8057 , 8057 , 0 , 7249 , 4691 , 2558 , 11.1463650158643 
05-May-2016 09:32,201603,NORTH AFRICA,TUNISIA,BELFAST INTERNATIONAL,ENFIDHA - HAMMAMET INTL, 0 , 0 , 0 , 2041 , 0 , 2041 , 0 
05-May-2016 09:32,201603,NORTH AFRICA,TUNISIA,BIRMINGHAM,ENFIDHA - HAMMAMET INTL, 0 , 0 , 0 , 5452 , 0 , 5452 , 0 
05-May-2016 09:32,201603,NORTH AFRICA,TUNISIA,BRISTOL,ENFIDHA - HAMMAMET INTL, 0 , 0 , 0 , 1042 , 0 , 1042 , 0 
05-May-2016 09:32,201603,NORTH AFRICA,TUNISIA,CARDIFF WALES,ENFIDHA - HAMMAMET INTL, 0 , 0 , 0 , 157 , 0 , 157 , 0 
05-May-2016 09:32,201603,NORTH AFRICA,TUNISIA,DONCASTER SHEFFIELD,ENFIDHA - HAMMAMET INTL, 0 , 0 , 0 , 183 , 0 , 183 , 0 
05-May-2016 09:32,201603,NORTH AFRICA,TUNISIA,EAST MIDLANDS INTERNATIONAL,ENFIDHA - HAMMAMET INTL, 0 , 0 , 0 , 5404 , 0 , 5404 , 0 
05-May-2016 09:32,201603,NORTH AFRICA,TUNISIA,GATWICK,ENFIDHA - HAMMAMET INTL, 0 , 0 , 0 , 7981 , 217 , 7764 , 0 
05-May-2016 09:32,201603,NORTH AFRICA,TUNISIA,GATWICK,TUNIS, 1721 , 1721 , 0 , 1840 , 1840 , 0 ,-6.46739130434783 
05-May-2016 09:32,201603,NORTH AFRICA,TUNISIA,GLASGOW,ENFIDHA - HAMMAMET INTL, 0 , 0 , 0 , 5415 , 0 , 5415 , 0 
05-May-2016 09:32,201603,NORTH AFRICA,TUNISIA,HEATHROW,TUNIS, 3270 , 3270 , 0 , 3764 , 3764 , 0 ,-13.1243358129649 
05-May-2016 09:32,201603,NORTH AFRICA,TUNISIA,LUTON,ENFIDHA - HAMMAMET INTL, 0 , 0 , 0 , 176 , 0 , 176 , 0 
05-May-2016 09:32,201603,NORTH AFRICA,TUNISIA,MANCHESTER,ENFIDHA - HAMMAMET INTL, 0 , 0 , 0 , 10631 , 270 , 10361 , 0 
05-May-2016 09:32,201603,NORTH AFRICA,TUNISIA,NEWCASTLE,ENFIDHA - HAMMAMET INTL, 0 , 0 , 0 , 1515 , 0 , 1515 , 0 
05-May-2016 09:32,201603,NORTH AFRICA,TUNISIA,STANSTED,ENFIDHA - HAMMAMET INTL, 0 , 0 , 0 , 630 , 0 , 630 , 0 
05-May-2016 09:32,201603,WESTERN EUROPE-OTHER,TURKEY,BIRMINGHAM,ANTALYA, 3048 , 0 , 3048 , 3436 , 0 , 3436 ,-11.2922002328289 
05-May-2016 09:32,201603,WESTERN EUROPE-OTHER,TURKEY,BIRMINGHAM,DALAMAN, 1409 , 0 , 1409 , 1065 , 385 , 680 , 32.3004694835681 
05-May-2016 09:32,201603,WESTERN EUROPE-OTHER,TURKEY,BIRMINGHAM,ISTANBUL, 11630 , 11630 , 0 , 9773 , 9773 , 0 , 19.0013301954364 
05-May-2016 09:32,201603,WESTERN EUROPE-OTHER,TURKEY,BIRMINGHAM,ISTANBUL (SABIHA GOKCEN), 0 , 0 , 0 , 343 , 0 , 343 , 0 
05-May-2016 09:32,201603,WESTERN EUROPE-OTHER,TURKEY,BIRMINGHAM,IZMIR (ADNAN MENDERES), 0 , 0 , 0 , 902 , 0 , 902 , 0 
05-May-2016 09:32,201603,WESTERN EUROPE-OTHER,TURKEY,BRISTOL,ANTALYA, 220 , 0 , 220 , 428 , 0 , 428 ,-48.5981308411215 
05-May-2016 09:32,201603,WESTERN EUROPE-OTHER,TURKEY,BRISTOL,BODRUM (MILAS), 211 , 211 , 0 , 385 , 385 , 0 ,-45.1948051948052 
05-May-2016 09:32,201603,WESTERN EUROPE-OTHER,TURKEY,BRISTOL,DALAMAN, 222 , 222 , 0 , 207 , 0 , 207 , 7.2463768115942 
05-May-2016 09:32,201603,WESTERN EUROPE-OTHER,TURKEY,EAST MIDLANDS INTERNATIONAL,ANTALYA, 1874 , 0 , 1874 , 423 , 0 , 423 , 343.026004728132 
05-May-2016 09:32,201603,WESTERN EUROPE-OTHER,TURKEY,EDINBURGH,BODRUM (MILAS), 184 , 184 , 0 , 178 , 178 , 0 , 3.37078651685393 
05-May-2016 09:32,201603,WESTERN EUROPE-OTHER,TURKEY,EDINBURGH,DALAMAN, 207 , 207 , 0 , 195 , 195 , 0 , 6.15384615384615 
05-May-2016 09:32,201603,WESTERN EUROPE-OTHER,TURKEY,EDINBURGH,ISTANBUL, 7053 , 7053 , 0 , 6440 , 6440 , 0 , 9.51863354037267 
05-May-2016 09:32,201603,WESTERN EUROPE-OTHER,TURKEY,GATWICK,ANTALYA, 10547 , 4761 , 5786 , 9426 , 558 , 8868 , 11.8926373859537 
05-May-2016 09:32,201603,WESTERN EUROPE-OTHER,TURKEY,GATWICK,BODRUM (MILAS), 722 , 722 , 0 , 269 , 269 , 0 , 168.401486988848 
05-May-2016 09:32,201603,WESTERN EUROPE-OTHER,TURKEY,GATWICK,DALAMAN, 1865 , 1306 , 559 , 5045 , 1044 , 4001 ,-63.0327056491576 
05-May-2016 09:32,201603,WESTERN EUROPE-OTHER,TURKEY,GATWICK,ISTANBUL, 21788 , 21788 , 0 , 19259 , 19259 , 0 , 13.1315229243471 
05-May-2016 09:32,201603,WESTERN EUROPE-OTHER,TURKEY,GATWICK,ISTANBUL (SABIHA GOKCEN), 14802 , 14802 , 0 , 7033 , 6184 , 849 , 110.464950945542 
05-May-2016 09:32,201603,WESTERN EUROPE-OTHER,TURKEY,GATWICK,IZMIR (ADNAN MENDERES), 238 , 238 , 0 , 3069 , 240 , 2829 ,-92.2450309547084 
05-May-2016 09:32,201603,WESTERN EUROPE-OTHER,TURKEY,GLASGOW,ANTALYA, 3793 , 203 , 3590 , 6713 , 0 , 6713 ,-43.4976910472218 
05-May-2016 09:32,201603,WESTERN EUROPE-OTHER,TURKEY,HEATHROW,ISTANBUL, 73433 , 73433 , 0 , 72935 , 72935 , 0 , 0.682799753204908 
05-May-2016 09:32,201603,WESTERN EUROPE-OTHER,TURKEY,LEEDS BRADFORD,ANTALYA, 193 , 193 , 0 , 173 , 173 , 0 , 11.5606936416185 
05-May-2016 09:32,201603,WESTERN EUROPE-OTHER,TURKEY,LEEDS BRADFORD,DALAMAN, 0 , 0 , 0 , 179 , 179 , 0 , 0 
05-May-2016 09:32,201603,WESTERN EUROPE-OTHER,TURKEY,LIVERPOOL (JOHN LENNON),BODRUM (MILAS), 226 , 226 , 0 , 222 , 222 , 0 , 1.8018018018018 
05-May-2016 09:32,201603,WESTERN EUROPE-OTHER,TURKEY,LUTON,ANKARA (ESENBOGA), 62 , 0 , 62 , 0 , 0 , 0 , 0 
05-May-2016 09:32,201603,WESTERN EUROPE-OTHER,TURKEY,LUTON,ISTANBUL, 5375 , 5375 , 0 , 4421 , 4421 , 0 , 21.5788283193848 
05-May-2016 09:32,201603,WESTERN EUROPE-OTHER,TURKEY,LUTON,ISTANBUL (SABIHA GOKCEN), 47 , 0 , 47 , 0 , 0 , 0 , 0 
05-May-2016 09:32,201603,WESTERN EUROPE-OTHER,TURKEY,LUTON,TRABZON, 51 , 0 , 51 , 0 , 0 , 0 , 0 
05-May-2016 09:32,201603,WESTERN EUROPE-OTHER,TURKEY,MANCHESTER,ANTALYA, 7575 , 400 , 7175 , 9881 , 178 , 9703 ,-23.337718854367 
05-May-2016 09:32,201603,WESTERN EUROPE-OTHER,TURKEY,MANCHESTER,DALAMAN, 1261 , 1075 , 186 , 2437 , 175 , 2262 ,-48.2560525235946 
05-May-2016 09:32,201603,WESTERN EUROPE-OTHER,TURKEY,MANCHESTER,ISTANBUL, 22863 , 22863 , 0 , 16343 , 16343 , 0 , 39.8947561647188 
05-May-2016 09:32,201603,WESTERN EUROPE-OTHER,TURKEY,MANCHESTER,ISTANBUL (SABIHA GOKCEN), 0 , 0 , 0 , 348 , 0 , 348 , 0 
05-May-2016 09:32,201603,WESTERN EUROPE-OTHER,TURKEY,MANCHESTER,IZMIR (ADNAN MENDERES), 0 , 0 , 0 , 949 , 0 , 949 , 0 
05-May-2016 09:32,201603,WESTERN EUROPE-OTHER,TURKEY,NEWCASTLE,ANTALYA, 0 , 0 , 0 , 148 , 0 , 148 , 0 
05-May-2016 09:32,201603,WESTERN EUROPE-OTHER,TURKEY,NEWCASTLE,DALAMAN, 474 , 0 , 474 , 0 , 0 , 0 , 0 
05-May-2016 09:32,201603,WESTERN EUROPE-OTHER,TURKEY,STANSTED,ANTALYA, 1961 , 0 , 1961 , 1773 , 0 , 1773 , 10.6034968979131 
05-May-2016 09:32,201603,WESTERN EUROPE-OTHER,TURKEY,STANSTED,DALAMAN, 255 , 255 , 0 , 689 , 0 , 689 ,-62.9898403483309 
05-May-2016 09:32,201603,WESTERN EUROPE-OTHER,TURKEY,STANSTED,ISTANBUL, 212 , 212 , 0 , 0 , 0 , 0 , 0 
05-May-2016 09:32,201603,WESTERN EUROPE-OTHER,TURKEY,STANSTED,ISTANBUL (SABIHA GOKCEN), 16979 , 16979 , 0 , 18965 , 18965 , 0 ,-10.471921961508 
05-May-2016 09:32,201603,WESTERN EUROPE-OTHER,TURKEY,STANSTED,IZMIR (ADNAN MENDERES), 2347 , 2347 , 0 , 2549 , 2549 , 0 ,-7.92467634366418 
05-May-2016 09:32,201603,EASTERN EUROPE -OTHER,TURKMENISTAN,BIRMINGHAM,ASHKHABAD, 4580 , 4580 , 0 , 6219 , 6219 , 0 ,-26.354719408265 
05-May-2016 09:32,201603,EASTERN EUROPE -OTHER,TURKMENISTAN,HEATHROW,ASHKHABAD, 1378 , 1378 , 0 , 2175 , 2175 , 0 ,-36.6436781609195 
05-May-2016 09:32,201603,CARIBBEAN AREA,TURKS AND CAICOS ISLANDS,GATWICK,PROVIDENCIALES, 3742 , 3742 , 0 , 525 , 525 , 0 , 612.761904761905 
05-May-2016 09:32,201603,CARIBBEAN AREA,TURKS AND CAICOS ISLANDS,HEATHROW,PROVIDENCIALES, 0 , 0 , 0 , 522 , 522 , 0 , 0 
05-May-2016 09:32,201603,EAST AFRICA,UGANDA,HEATHROW,ENTEBBE, 0 , 0 , 0 , 4575 , 4575 , 0 , 0 
05-May-2016 09:32,201603,EASTERN EUROPE -OTHER,UKRAINE,CARDIFF WALES,KIEV (ZHULYANY), 139 , 0 , 139 , 0 , 0 , 0 , 0 
05-May-2016 09:32,201603,EASTERN EUROPE -OTHER,UKRAINE,GATWICK,KIEV (BORISPOL), 11188 , 11188 , 0 , 7476 , 7476 , 0 , 49.6522204387373 
05-May-2016 09:32,201603,EASTERN EUROPE -OTHER,UKRAINE,HEATHROW,KIEV (BORISPOL), 6161 , 6161 , 0 , 4633 , 4633 , 0 , 32.980789984891 
05-May-2016 09:32,201603,EASTERN EUROPE -OTHER,UKRAINE,LIVERPOOL (JOHN LENNON),KIEV (BORISPOL), 0 , 0 , 0 , 299 , 0 , 299 , 0 
05-May-2016 09:32,201603,EASTERN EUROPE -OTHER,UKRAINE,LIVERPOOL (JOHN LENNON),KIEV (ZHULYANY), 0 , 0 , 0 , 460 , 0 , 460 , 0 
05-May-2016 09:32,201603,EASTERN EUROPE -OTHER,UKRAINE,LUTON,KIEV (ZHULYANY), 2250 , 2250 , 0 , 2455 , 2455 , 0 ,-8.35030549898167 
05-May-2016 09:32,201603,EASTERN EUROPE -OTHER,UKRAINE,LUTON,ODESSA, 4 , 0 , 4 , 0 , 0 , 0 , 0 
05-May-2016 09:32,201603,EASTERN EUROPE -OTHER,UKRAINE,MANCHESTER,KIEV (ZHULYANY), 323 , 0 , 323 , 0 , 0 , 0 , 0 
05-May-2016 09:32,201603,MIDDLE EAST,UNITED ARAB EMIRATES,BIRMINGHAM,DUBAI, 68669 , 68669 , 0 , 51102 , 51102 , 0 , 34.3763453485186 
05-May-2016 09:32,201603,MIDDLE EAST,UNITED ARAB EMIRATES,BIRMINGHAM,DUBAI (WORLD CENTRAL), 0 , 0 , 0 , 1 , 0 , 1 , 0 
05-May-2016 09:32,201603,MIDDLE EAST,UNITED ARAB EMIRATES,EDINBURGH,ABU DHABI INTERNATIONAL, 8794 , 8794 , 0 , 0 , 0 , 0 , 0 
05-May-2016 09:32,201603,MIDDLE EAST,UNITED ARAB EMIRATES,GATWICK,DUBAI, 83727 , 83727 , 0 , 70919 , 70919 , 0 , 18.0600403276978 
05-May-2016 09:32,201603,MIDDLE EAST,UNITED ARAB EMIRATES,GLASGOW,DUBAI, 37191 , 37191 , 0 , 38058 , 38058 , 0 ,-2.27810184455305 
05-May-2016 09:32,201603,MIDDLE EAST,UNITED ARAB EMIRATES,HEATHROW,ABU DHABI INTERNATIONAL, 73267 , 73267 , 0 , 65512 , 65512 , 0 , 11.8375259494444 
05-May-2016 09:32,201603,MIDDLE EAST,UNITED ARAB EMIRATES,HEATHROW,DUBAI, 229089 , 229089 , 0 , 216026 , 216026 , 0 , 6.04695731069408 
05-May-2016 09:32,201603,MIDDLE EAST,UNITED ARAB EMIRATES,MANCHESTER,ABU DHABI INTERNATIONAL, 43305 , 43305 , 0 , 38938 , 38938 , 0 , 11.2152652935436 
05-May-2016 09:32,201603,MIDDLE EAST,UNITED ARAB EMIRATES,MANCHESTER,DUBAI, 88261 , 88261 , 0 , 78859 , 78859 , 0 , 11.9225453023751 
05-May-2016 09:32,201603,MIDDLE EAST,UNITED ARAB EMIRATES,NEWCASTLE,DUBAI, 21879 , 21879 , 0 , 21305 , 21305 , 0 , 2.69420323867637 
05-May-2016 09:32,201603,UNITED STATES OF AMERICA,USA,BELFAST INTERNATIONAL,NEW YORK (NEWARK), 4629 , 4629 , 0 , 3476 , 3476 , 0 , 33.1703107019563 
05-May-2016 09:32,201603,UNITED STATES OF AMERICA,USA,BIRMINGHAM,NEW YORK (JF KENNEDY), 5091 , 5091 , 0 , 0 , 0 , 0 , 0 
05-May-2016 09:32,201603,UNITED STATES OF AMERICA,USA,BIRMINGHAM,NEW YORK (NEWARK), 5920 , 5920 , 0 , 6828 , 6828 , 0 ,-13.2981839484476 
05-May-2016 09:32,201603,UNITED STATES OF AMERICA,USA,BIRMINGHAM,SANFORD, 579 , 0 , 579 , 290 , 0 , 290 , 99.6551724137931 
05-May-2016 09:32,201603,UNITED STATES OF AMERICA,USA,EDINBURGH,NEW YORK (JF KENNEDY), 1061 , 1061 , 0 , 0 , 0 , 0 , 0 
05-May-2016 09:32,201603,UNITED STATES OF AMERICA,USA,EDINBURGH,NEW YORK (NEWARK), 8959 , 8959 , 0 , 8908 , 8908 , 0 , 0.572519083969466 
05-May-2016 09:32,201603,UNITED STATES OF AMERICA,USA,GATWICK,BOSTON, 1714 , 1714 , 0 , 0 , 0 , 0 , 0 
05-May-2016 09:32,201603,UNITED STATES OF AMERICA,USA,GATWICK,FORT LAUDERDALE, 4944 , 4944 , 0 , 4728 , 4728 , 0 , 4.56852791878173 
05-May-2016 09:32,201603,UNITED STATES OF AMERICA,USA,GATWICK,LAS VEGAS, 26505 , 26505 , 0 , 24149 , 24149 , 0 , 9.75609756097561 
05-May-2016 09:32,201603,UNITED STATES OF AMERICA,USA,GATWICK,LOS ANGELES INTERNATIONAL, 7969 , 7969 , 0 , 4896 , 4896 , 0 , 62.765522875817 
05-May-2016 09:32,201603,UNITED STATES OF AMERICA,USA,GATWICK,NEW YORK (JF KENNEDY), 18538 , 18538 , 0 , 7457 , 7457 , 0 , 148.598632157704 
05-May-2016 09:32,201603,UNITED STATES OF AMERICA,USA,GATWICK,ORLANDO, 50425 , 50425 , 0 , 49747 , 49747 , 0 , 1.36289625505056 
05-May-2016 09:32,201603,UNITED STATES OF AMERICA,USA,GATWICK,SANFORD, 590 , 0 , 590 , 295 , 0 , 295 , 100 
05-May-2016 09:32,201603,UNITED STATES OF AMERICA,USA,GATWICK,TAMPA, 12763 , 12763 , 0 , 13206 , 13206 , 0 ,-3.35453581705285 
05-May-2016 09:32,201603,UNITED STATES OF AMERICA,USA,GLASGOW,NEW YORK (NEWARK), 8749 , 8749 , 0 , 9084 , 9084 , 0 ,-3.68780273007486 
05-May-2016 09:32,201603,UNITED STATES OF AMERICA,USA,GLASGOW,ORLANDO, 0 , 0 , 0 , 459 , 459 , 0 , 0 
05-May-2016 09:32,201603,UNITED STATES OF AMERICA,USA,HEATHROW,ATLANTA, 48213 , 48213 , 0 , 45381 , 45381 , 0 , 6.24049712434719 
05-May-2016 09:32,201603,UNITED STATES OF AMERICA,USA,HEATHROW,AUSTIN (BERGSTROM), 11369 , 11369 , 0 , 11161 , 11161 , 0 , 1.86363229101335 
05-May-2016 09:32,201603,UNITED STATES OF AMERICA,USA,HEATHROW,BALTIMORE, 9628 , 9628 , 0 , 9144 , 9144 , 0 , 5.29308836395451 
05-May-2016 09:32,201603,UNITED STATES OF AMERICA,USA,HEATHROW,BOSTON, 59543 , 59543 , 0 , 61398 , 61398 , 0 ,-3.02127105117431 
05-May-2016 09:32,201603,UNITED STATES OF AMERICA,USA,HEATHROW,CHARLOTTE, 25466 , 25466 , 0 , 23247 , 23247 , 0 , 9.54531767539898 
05-May-2016 09:32,201603,UNITED STATES OF AMERICA,USA,HEATHROW,CHICAGO (O'HARE), 75928 , 75928 , 0 , 81046 , 81046 , 0 ,-6.31493226069146 
05-May-2016 09:32,201603,UNITED STATES OF AMERICA,USA,HEATHROW,DALLAS/FORT WORTH, 53413 , 53413 , 0 , 54913 , 54913 , 0 ,-2.73159361171307 
05-May-2016 09:32,201603,UNITED STATES OF AMERICA,USA,HEATHROW,DENVER INTERNATIONAL, 14729 , 14729 , 0 , 13809 , 13809 , 0 , 6.6623216742704 
05-May-2016 09:32,201603,UNITED STATES OF AMERICA,USA,HEATHROW,DETROIT, 15828 , 15828 , 0 , 9598 , 9598 , 0 , 64.9093561158575 
05-May-2016 09:32,201603,UNITED STATES OF AMERICA,USA,HEATHROW,HOUSTON, 41398 , 41398 , 0 , 49921 , 49921 , 0 ,-17.0729753009755 
05-May-2016 09:32,201603,UNITED STATES OF AMERICA,USA,HEATHROW,LAS VEGAS, 20644 , 20644 , 0 , 20343 , 20343 , 0 , 1.4796244408396 
05-May-2016 09:32,201603,UNITED STATES OF AMERICA,USA,HEATHROW,LOS ANGELES INTERNATIONAL, 124519 , 124519 , 0 , 113864 , 113864 , 0 , 9.35765474601279 
05-May-2016 09:32,201603,UNITED STATES OF AMERICA,USA,HEATHROW,MIAMI INTERNATIONAL, 100338 , 100338 , 0 , 93767 , 93767 , 0 , 7.00779591967323 
05-May-2016 09:32,201603,UNITED STATES OF AMERICA,USA,HEATHROW,MINNEAPOLIS-ST PAUL, 11875 , 11875 , 0 , 10368 , 10368 , 0 , 14.5351080246914 
05-May-2016 09:32,201603,UNITED STATES OF AMERICA,USA,HEATHROW,NEW YORK (JF KENNEDY), 239736 , 239736 , 0 , 220372 , 220372 , 0 , 8.78696023088233 
05-May-2016 09:32,201603,UNITED STATES OF AMERICA,USA,HEATHROW,NEW YORK (NEWARK), 73856 , 73856 , 0 , 84374 , 84374 , 0 ,-12.4659255220803 
05-May-2016 09:32,201603,UNITED STATES OF AMERICA,USA,HEATHROW,PHILADELPHIA INTERNATIONAL, 40348 , 40348 , 0 , 30443 , 30443 , 0 , 32.5362152218901 
05-May-2016 09:32,201603,UNITED STATES OF AMERICA,USA,HEATHROW,PHOENIX, 18843 , 18843 , 0 , 19050 , 19050 , 0 ,-1.08661417322835 
05-May-2016 09:32,201603,UNITED STATES OF AMERICA,USA,HEATHROW,RALEIGH, 9009 , 9009 , 0 , 9454 , 9454 , 0 ,-4.70700232705733 
05-May-2016 09:32,201603,UNITED STATES OF AMERICA,USA,HEATHROW,SAN DIEGO, 14819 , 14819 , 0 , 15391 , 15391 , 0 ,-3.71645767006692 
05-May-2016 09:32,201603,UNITED STATES OF AMERICA,USA,HEATHROW,SAN FRANCISCO, 76716 , 76716 , 0 , 69095 , 69095 , 0 , 11.0297416600333 
05-May-2016 09:32,201603,UNITED STATES OF AMERICA,USA,HEATHROW,SEATTLE (TACOMA), 28735 , 28735 , 0 , 25716 , 25716 , 0 , 11.7397729040286 
05-May-2016 09:32,201603,UNITED STATES OF AMERICA,USA,HEATHROW,WASHINGTON (DULLES), 69635 , 69635 , 0 , 63106 , 63106 , 0 , 10.3460843659874 
05-May-2016 09:32,201603,UNITED STATES OF AMERICA,USA,LONDON CITY,NEW YORK (JF KENNEDY), 1832 , 1832 , 0 , 2085 , 2085 , 0 ,-12.1342925659472 
05-May-2016 09:32,201603,UNITED STATES OF AMERICA,USA,LUTON,NEW YORK (NEWARK), 1667 , 1667 , 0 , 0 , 0 , 0 , 0 
05-May-2016 09:32,201603,UNITED STATES OF AMERICA,USA,MANCHESTER,ATLANTA, 12360 , 12360 , 0 , 8841 , 8841 , 0 , 39.8031896844248 
05-May-2016 09:32,201603,UNITED STATES OF AMERICA,USA,MANCHESTER,CHICAGO (O'HARE), 1004 , 1004 , 0 , 0 , 0 , 0 , 0 
05-May-2016 09:32,201603,UNITED STATES OF AMERICA,USA,MANCHESTER,LAS VEGAS, 6668 , 6668 , 0 , 554 , 554 , 0 , 1103.61010830325 
05-May-2016 09:32,201603,UNITED STATES OF AMERICA,USA,MANCHESTER,MIAMI INTERNATIONAL, 344 , 0 , 344 , 0 , 0 , 0 , 0 
05-May-2016 09:32,201603,UNITED STATES OF AMERICA,USA,MANCHESTER,NEW YORK (JF KENNEDY), 17420 , 17420 , 0 , 7797 , 7797 , 0 , 123.419263819418 
05-May-2016 09:32,201603,UNITED STATES OF AMERICA,USA,MANCHESTER,NEW YORK (NEWARK), 8737 , 8737 , 0 , 9440 , 9440 , 0 ,-7.44703389830508 
05-May-2016 09:32,201603,UNITED STATES OF AMERICA,USA,MANCHESTER,ORLANDO, 28471 , 28471 , 0 , 25723 , 25723 , 0 , 10.6830463009758 
05-May-2016 09:32,201603,UNITED STATES OF AMERICA,USA,MANCHESTER,PHILADELPHIA INTERNATIONAL, 10810 , 10810 , 0 , 11299 , 11299 , 0 ,-4.32781662093991 
05-May-2016 09:32,201603,UNITED STATES OF AMERICA,USA,MANCHESTER,SANFORD, 888 , 0 , 888 , 872 , 0 , 872 , 1.8348623853211 
05-May-2016 09:32,201603,UNITED STATES OF AMERICA,USA,MANCHESTER,WASHINGTON (DULLES), 2003 , 2003 , 0 , 5025 , 5025 , 0 ,-60.1393034825871 
05-May-2016 09:32,201603,UNITED STATES OF AMERICA,USA,NEWCASTLE,SANFORD, 300 , 0 , 300 , 289 , 0 , 289 , 3.80622837370242 
05-May-2016 09:32,201603,UNITED STATES OF AMERICA,USA,PRESTWICK,SEATTLE (TACOMA), 4 , 4 , 0 , 0 , 0 , 0 , 0 
05-May-2016 09:32,201603,EASTERN EUROPE -OTHER,UZBEKISTAN,GATWICK,TASHKENT, 0 , 0 , 0 , 76 , 0 , 76 , 0 
05-May-2016 09:32,201603,EASTERN EUROPE -OTHER,UZBEKISTAN,HEATHROW,TASHKENT, 2216 , 2216 , 0 , 2341 , 2341 , 0 ,-5.33959846219564 
05-May-2016 09:32,201603,FAR EAST,VIETNAM,GATWICK,HANOI, 0 , 0 , 0 , 3989 , 3989 , 0 , 0 
05-May-2016 09:32,201603,FAR EAST,VIETNAM,GATWICK,HO CHI MINH CITY, 0 , 0 , 0 , 3925 , 3925 , 0 , 0 
05-May-2016 09:32,201603,FAR EAST,VIETNAM,HEATHROW,HANOI, 5690 , 5690 , 0 , 543 , 543 , 0 , 947.882136279926 
05-May-2016 09:32,201603,FAR EAST,VIETNAM,HEATHROW,HO CHI MINH CITY, 5476 , 5476 , 0 , 0 , 0 , 0 , 0 
